1: { ⊢ (c_in (c_Message_Omsg_OMPair v_X v_Y) (c_union (c_Message_Oanalz (c_union v_G v_H tc_Message_Omsg)) (c_Message_Osynth v_G) tc_Message_Omsg) tc_Message_Omsg)} 	: Axiom()[]
2: {(c_in U (c_union V W X) X) ⊢ (c_in U W X), (c_in U V X)} 	: Axiom()[]
3: { ⊢ (c_in (c_Message_Omsg_OMPair v_X v_Y) (c_Message_Osynth v_G) tc_Message_Omsg), (c_in (c_Message_Omsg_OMPair v_X v_Y) (c_Message_Oanalz (c_union v_G v_H tc_Message_Omsg)) tc_Message_Omsg)} 	: UnifyingResolutionMRR(1, 2)[]
4: {(c_in (c_Message_Omsg_OMPair U V) (c_Message_Oanalz W) tc_Message_Omsg) ⊢ (c_in U (c_Message_Oanalz W) tc_Message_Omsg)} 	: Axiom()[]
5: { ⊢ (c_in (c_Message_Omsg_OMPair v_X v_Y) (c_Message_Osynth v_G) tc_Message_Omsg), (c_in v_X (c_Message_Oanalz (c_union v_G v_H tc_Message_Omsg)) tc_Message_Omsg)} 	: UnifyingResolutionMRR(3, 4)[]
6: {(c_in (c_Message_Omsg_OMPair U V) (c_Message_Osynth W) tc_Message_Omsg) ⊢ (c_in (c_Message_Omsg_OMPair U V) W tc_Message_Omsg), (c_in U (c_Message_Osynth W) tc_Message_Omsg)} 	: Axiom()[]
7: { ⊢ (c_in v_X (c_Message_Oanalz (c_union v_G v_H tc_Message_Omsg)) tc_Message_Omsg), (c_in (c_Message_Omsg_OMPair v_X v_Y) v_G tc_Message_Omsg), (c_in v_X (c_Message_Osynth v_G) tc_Message_Omsg)} 	: UnifyingResolutionMRR(5, 6)[]
8: {(c_in U V W) ⊢ (c_in U (c_union V X W) W)} 	: Axiom()[]
9: {(c_in U V tc_Message_Omsg) ⊢ (c_in U (c_Message_Oanalz V) tc_Message_Omsg)} 	: Axiom()[]
10: {(c_in (c_Message_Omsg_OMPair U V) W tc_Message_Omsg) ⊢ (c_in U (c_Message_Oanalz W) tc_Message_Omsg)} 	: UnifyingResolutionMRR(9, 4)[]
11: {(c_in (c_Message_Omsg_OMPair U V) NEW0 tc_Message_Omsg) ⊢ (c_in U (c_Message_Oanalz (c_union NEW0 X tc_Message_Omsg)) tc_Message_Omsg)} 	: UnifyingResolutionMRR(8, 10)[]
12: { ⊢ (c_in v_X (c_Message_Oanalz (c_union v_G v_H tc_Message_Omsg)) tc_Message_Omsg), (c_in v_X (c_Message_Osynth v_G) tc_Message_Omsg), (c_in v_X (c_Message_Oanalz (c_union v_G X tc_Message_Omsg)) tc_Message_Omsg)} 	: UnifyingResolutionMRR(7, 11)[]
13: { ⊢ (c_in v_X (c_Message_Oanalz (c_union v_G v_H tc_Message_Omsg)) tc_Message_Omsg), (c_in v_X (c_Message_Osynth v_G) tc_Message_Omsg), (c_in v_X (c_Message_Oanalz (c_union v_G v_H tc_Message_Omsg)) tc_Message_Omsg)} 	: FOSubstitution(12)[]
14: {(c_in U V W) ⊢ (c_in U (c_union X V W) W)} 	: Axiom()[]
15: {(c_in v_X (c_union (c_Message_Oanalz (c_union v_G v_H tc_Message_Omsg)) (c_Message_Osynth v_G) tc_Message_Omsg) tc_Message_Omsg) ⊢ } 	: Axiom()[]
16: {(c_in v_X (c_Message_Osynth v_G) tc_Message_Omsg) ⊢ } 	: UnifyingResolutionMRR(14, 15)[]
17: { ⊢ (c_in v_X (c_Message_Oanalz (c_union v_G v_H tc_Message_Omsg)) tc_Message_Omsg), (c_in v_X (c_Message_Oanalz (c_union v_G v_H tc_Message_Omsg)) tc_Message_Omsg)} 	: UnifyingResolutionMRR(13, 16)[]
18: { ⊢ (c_in v_X (c_Message_Oanalz (c_union v_G v_H tc_Message_Omsg)) tc_Message_Omsg)} 	: Contraction(17)[]
19: {(c_in v_X (c_Message_Oanalz (c_union v_G v_H tc_Message_Omsg)) tc_Message_Omsg) ⊢ } 	: UnifyingResolutionMRR(8, 15)[]
20: { ⊢ } 	: UnifyingResolution(18, 19)[]

