1: { ⊢ (subset_sets U U)} 	: Axiom()[]
2: { ⊢ (basis cx f)} 	: Axiom()[]
3: {(basis U V) ⊢ (equal_sets (union_of_members V) U)} 	: Axiom()[]
4: { ⊢ (equal_sets (union_of_members f) cx)} 	: UnifyingResolution(2, 3)[]
5: {(equal_sets U V) ⊢ (subset_sets U V)} 	: Axiom()[]
6: { ⊢ (element_of_set (in_1st_set U V) U), (subset_sets U V)} 	: Axiom()[]
7: {(subset_sets V W), (element_of_set U V) ⊢ (element_of_set U W)} 	: Axiom()[]
8: {(subset_sets V W) ⊢ (subset_sets V X1), (element_of_set (in_1st_set V X1) W)} 	: UnifyingResolution(6, 7)[]
9: {(subset_sets X V), (subset_sets V W) ⊢ (subset_sets X X1), (element_of_set (in_1st_set X X1) W)} 	: UnifyingResolution(8, 7)[]
10: {(equal_sets X V), (subset_sets V W) ⊢ (subset_sets X X1), (element_of_set (in_1st_set X X1) W)} 	: UnifyingResolution(5, 9)[]
11: {(subset_sets cx W) ⊢ (subset_sets (union_of_members f) X1), (element_of_set (in_1st_set (union_of_members f) X1) W)} 	: UnifyingResolution(4, 10)[]
12: {(element_of_set (in_1st_set U V) V) ⊢ (subset_sets U V)} 	: Axiom()[]
13: {(subset_sets cx V) ⊢ (subset_sets (union_of_members f) V), (subset_sets (union_of_members f) V)} 	: UnifyingResolution(11, 12)[]
14: {(subset_sets cx U) ⊢ (subset_sets (union_of_members f) U)} 	: Contraction(13)[]
15: {(element_of_set U (union_of_members V)) ⊢ (element_of_set U (f1 V U))} 	: Axiom()[]
16: {(element_of_set U (union_of_members V)) ⊢ (element_of_collection (f1 V U) V)} 	: Axiom()[]
17: {(element_of_collection V (top_of_basis W)), (element_of_set U V) ⊢ (element_of_set U (f10 W V U))} 	: Axiom()[]
18: {(element_of_collection V (top_of_basis W)), (element_of_set U V) ⊢ (element_of_collection (f10 W V U) W)} 	: Axiom()[]
19: {(element_of_set W U), (element_of_collection U V) ⊢ (element_of_set W (union_of_members V))} 	: Axiom()[]
20: {(element_of_set X X1), (element_of_collection X1 (top_of_basis V)), (element_of_set W (f10 V X1 X)) ⊢ (element_of_set W (union_of_members V))} 	: UnifyingResolution(18, 19)[]
21: {(element_of_set X X1), (element_of_collection X1 (top_of_basis V)), (element_of_set X X1), (element_of_collection X1 (top_of_basis V)) ⊢ (element_of_set X (union_of_members V))} 	: UnifyingResolution(17, 20)[]
22: {(element_of_collection V (top_of_basis W)), (element_of_set U V) ⊢ (element_of_set U (union_of_members W))} 	: Contraction(21)[]
23: {(element_of_set X (union_of_members (top_of_basis W))), (element_of_set U (f1 (top_of_basis W) X)) ⊢ (element_of_set U (union_of_members W))} 	: UnifyingResolution(16, 22)[]
24: {(element_of_set X (union_of_members (top_of_basis W))), (element_of_set X (union_of_members (top_of_basis W))) ⊢ (element_of_set X (union_of_members W))} 	: UnifyingResolution(15, 23)[]
25: {(element_of_set U (union_of_members (top_of_basis V))) ⊢ (element_of_set U (union_of_members V))} 	: Contraction(24)[]
26: { ⊢ (subset_sets (union_of_members (top_of_basis V)) X1), (element_of_set (in_1st_set (union_of_members (top_of_basis V)) X1) (union_of_members V))} 	: UnifyingResolution(6, 25)[]
27: {(subset_sets (union_of_members X) W) ⊢ (subset_sets (union_of_members (top_of_basis X)) X1), (element_of_set (in_1st_set (union_of_members (top_of_basis X)) X1) W)} 	: UnifyingResolution(26, 7)[]
28: {(subset_sets (union_of_members X) V) ⊢ (subset_sets (union_of_members (top_of_basis X)) V), (subset_sets (union_of_members (top_of_basis X)) V)} 	: UnifyingResolution(27, 12)[]
29: {(subset_sets (union_of_members U) V) ⊢ (subset_sets (union_of_members (top_of_basis U)) V)} 	: Contraction(28)[]
30: {(subset_sets (union_of_members (top_of_basis f)) cx) ⊢ } 	: Axiom()[]
31: {(subset_sets (union_of_members f) cx) ⊢ } 	: UnifyingResolution(29, 30)[]
32: {(subset_sets cx cx) ⊢ } 	: UnifyingResolution(14, 31)[]
33: { ⊢ } 	: UnifyingResolution(1, 32)[]

