1: { ⊢ (c_in v_X (c_Message_Osynth (c_Message_Oanalz (c_Event_Oknows c_Message_Oagent_OSpy v_evsf))) tc_Message_Omsg)} 	: Axiom()[]
2: { ⊢ (c_in (c_Message_Omsg_OCrypt (c_Public_OshrK v_B) (c_Message_Omsg_OMPair (c_Message_Omsg_OAgent v_A) (c_Message_Omsg_OKey v_K))) (c_Message_Oparts (c_insert v_X (c_Event_Oknows c_Message_Oagent_OSpy v_evsf) tc_Message_Omsg)) tc_Message_Omsg)} 	: Axiom()[]
3: {(c_in W (c_Message_Oparts (c_insert U V tc_Message_Omsg)) tc_Message_Omsg), (c_in U (c_Message_Osynth (c_Message_Oanalz V)) tc_Message_Omsg) ⊢ (c_in W (c_union (c_Message_Osynth (c_Message_Oanalz V)) (c_Message_Oparts V) tc_Message_Omsg) tc_Message_Omsg)} 	: Axiom()[]
4: {(c_in v_X (c_Message_Osynth (c_Message_Oanalz (c_Event_Oknows c_Message_Oagent_OSpy v_evsf))) tc_Message_Omsg) ⊢ (c_in (c_Message_Omsg_OCrypt (c_Public_OshrK v_B) (c_Message_Omsg_OMPair (c_Message_Omsg_OAgent v_A) (c_Message_Omsg_OKey v_K))) (c_union (c_Message_Osynth (c_Message_Oanalz (c_Event_Oknows c_Message_Oagent_OSpy v_evsf))) (c_Message_Oparts (c_Event_Oknows c_Message_Oagent_OSpy v_evsf)) tc_Message_Omsg) tc_Message_Omsg)} 	: UnifyingResolution(2, 3)[]
5: {(c_in U (c_union V W X) X) ⊢ (c_in U W X), (c_in U V X)} 	: Axiom()[]
6: {(c_in (c_Message_Omsg_OCrypt (c_Public_OshrK v_B) (c_Message_Omsg_OMPair (c_Message_Omsg_OAgent v_A) (c_Message_Omsg_OKey v_K))) (c_Message_Oparts (c_Event_Oknows c_Message_Oagent_OSpy v_evsf)) tc_Message_Omsg) ⊢ } 	: Axiom()[]
7: {(c_in (c_Message_Omsg_OCrypt (c_Public_OshrK v_B) (c_Message_Omsg_OMPair (c_Message_Omsg_OAgent v_A) (c_Message_Omsg_OKey v_K))) (c_union V (c_Message_Oparts (c_Event_Oknows c_Message_Oagent_OSpy v_evsf)) tc_Message_Omsg) tc_Message_Omsg) ⊢ (c_in (c_Message_Omsg_OCrypt (c_Public_OshrK v_B) (c_Message_Omsg_OMPair (c_Message_Omsg_OAgent v_A) (c_Message_Omsg_OKey v_K))) V tc_Message_Omsg)} 	: UnifyingResolution(5, 6)[]
8: {(c_in v_X (c_Message_Osynth (c_Message_Oanalz (c_Event_Oknows c_Message_Oagent_OSpy v_evsf))) tc_Message_Omsg) ⊢ (c_in (c_Message_Omsg_OCrypt (c_Public_OshrK v_B) (c_Message_Omsg_OMPair (c_Message_Omsg_OAgent v_A) (c_Message_Omsg_OKey v_K))) (c_Message_Osynth (c_Message_Oanalz (c_Event_Oknows c_Message_Oagent_OSpy v_evsf))) tc_Message_Omsg)} 	: UnifyingResolution(4, 7)[]
9: {(c_in (c_Message_Omsg_OCrypt U V) (c_Message_Osynth W) tc_Message_Omsg) ⊢ (c_in (c_Message_Omsg_OCrypt U V) W tc_Message_Omsg), (c_in (c_Message_Omsg_OKey U) W tc_Message_Omsg)} 	: Axiom()[]
10: {(c_in v_X (c_Message_Osynth (c_Message_Oanalz (c_Event_Oknows c_Message_Oagent_OSpy v_evsf))) tc_Message_Omsg) ⊢ (c_in (c_Message_Omsg_OCrypt (c_Public_OshrK v_B) (c_Message_Omsg_OMPair (c_Message_Omsg_OAgent v_A) (c_Message_Omsg_OKey v_K))) (c_Message_Oanalz (c_Event_Oknows c_Message_Oagent_OSpy v_evsf)) tc_Message_Omsg), (c_in (c_Message_Omsg_OKey (c_Public_OshrK v_B)) (c_Message_Oanalz (c_Event_Oknows c_Message_Oagent_OSpy v_evsf)) tc_Message_Omsg)} 	: UnifyingResolution(8, 9)[]
11: {(c_in U (c_Message_Oanalz V) tc_Message_Omsg) ⊢ (c_in U (c_Message_Oparts V) tc_Message_Omsg)} 	: Axiom()[]
12: {(c_in (c_Message_Omsg_OCrypt (c_Public_OshrK v_B) (c_Message_Omsg_OMPair (c_Message_Omsg_OAgent v_A) (c_Message_Omsg_OKey v_K))) (c_Message_Oanalz (c_Event_Oknows c_Message_Oagent_OSpy v_evsf)) tc_Message_Omsg) ⊢ } 	: UnifyingResolution(11, 6)[]
13: {(c_in v_X (c_Message_Osynth (c_Message_Oanalz (c_Event_Oknows c_Message_Oagent_OSpy v_evsf))) tc_Message_Omsg) ⊢ (c_in (c_Message_Omsg_OKey (c_Public_OshrK v_B)) (c_Message_Oanalz (c_Event_Oknows c_Message_Oagent_OSpy v_evsf)) tc_Message_Omsg)} 	: UnifyingResolution(10, 12)[]
14: { ⊢ (c_in v_evsf c_Yahalom_Oyahalom (tc_List_Olist tc_Event_Oevent))} 	: Axiom()[]
15: {(c_in (c_Message_Omsg_OKey (c_Public_OshrK V)) (c_Message_Oanalz (c_Event_Oknows c_Message_Oagent_OSpy U)) tc_Message_Omsg), (c_in U c_Yahalom_Oyahalom (tc_List_Olist tc_Event_Oevent)) ⊢ (c_in V c_Event_Obad tc_Message_Oagent)} 	: Axiom()[]
16: {(c_in (c_Message_Omsg_OKey (c_Public_OshrK V)) (c_Message_Oanalz (c_Event_Oknows c_Message_Oagent_OSpy v_evsf)) tc_Message_Omsg) ⊢ (c_in V c_Event_Obad tc_Message_Oagent)} 	: UnifyingResolution(14, 15)[]
17: {(c_in v_B c_Event_Obad tc_Message_Oagent) ⊢ } 	: Axiom()[]
18: {(c_in (c_Message_Omsg_OKey (c_Public_OshrK v_B)) (c_Message_Oanalz (c_Event_Oknows c_Message_Oagent_OSpy v_evsf)) tc_Message_Omsg) ⊢ } 	: UnifyingResolution(16, 17)[]
19: {(c_in v_X (c_Message_Osynth (c_Message_Oanalz (c_Event_Oknows c_Message_Oagent_OSpy v_evsf))) tc_Message_Omsg) ⊢ } 	: UnifyingResolution(13, 18)[]
20: { ⊢ } 	: UnifyingResolution(1, 19)[]

