1: { ⊢ (c_in (c_Event_Oevent_OSays v_Aaa v_Ba (c_Message_Omsg_OMPair (c_Message_Omsg_ONonce v_NAa) (c_Message_Omsg_OMPair v_X (c_Message_Omsg_OCrypt (c_Public_OshrK v_Ba) (c_Message_Omsg_OMPair (c_Message_Omsg_ONonce v_NB) (c_Message_Omsg_OKey v_Ka)))))) (c_List_Oset v_evs4 tc_Event_Oevent) tc_Event_Oevent)} 	: Axiom()[]
2: {(c_in (c_Event_Oevent_OSays U V W) (c_List_Oset X tc_Event_Oevent) tc_Event_Oevent) ⊢ (c_in W (c_Message_Oanalz (c_Event_Oknows c_Message_Oagent_OSpy X)) tc_Message_Omsg)} 	: Axiom()[]
3: { ⊢ (c_in (c_Message_Omsg_OMPair (c_Message_Omsg_ONonce v_NAa) (c_Message_Omsg_OMPair v_X (c_Message_Omsg_OCrypt (c_Public_OshrK v_Ba) (c_Message_Omsg_OMPair (c_Message_Omsg_ONonce v_NB) (c_Message_Omsg_OKey v_Ka))))) (c_Message_Oanalz (c_Event_Oknows c_Message_Oagent_OSpy v_evs4)) tc_Message_Omsg)} 	: UnifyingResolution(1, 2)[]
4: {(c_in (c_Message_Omsg_OMPair U V) (c_Message_Oanalz W) tc_Message_Omsg) ⊢ (c_in V (c_Message_Oanalz W) tc_Message_Omsg)} 	: Axiom()[]
5: { ⊢ (c_in (c_Message_Omsg_OMPair v_X (c_Message_Omsg_OCrypt (c_Public_OshrK v_Ba) (c_Message_Omsg_OMPair (c_Message_Omsg_ONonce v_NB) (c_Message_Omsg_OKey v_Ka)))) (c_Message_Oanalz (c_Event_Oknows c_Message_Oagent_OSpy v_evs4)) tc_Message_Omsg)} 	: UnifyingResolution(3, 4)[]
6: {(c_in U V tc_Message_Omsg) ⊢ (c_in U (c_Message_Osynth V) tc_Message_Omsg)} 	: Axiom()[]
7: {(c_in (c_Message_Omsg_OMPair U V) (c_Message_Osynth (c_Message_Oanalz W)) tc_Message_Omsg) ⊢ (c_in U (c_Message_Osynth (c_Message_Oanalz W)) tc_Message_Omsg)} 	: Axiom()[]
8: {(c_in (c_Message_Omsg_OMPair U V) (c_Message_Oanalz W) tc_Message_Omsg) ⊢ (c_in U (c_Message_Osynth (c_Message_Oanalz W)) tc_Message_Omsg)} 	: UnifyingResolution(6, 7)[]
9: { ⊢ (c_in v_X (c_Message_Osynth (c_Message_Oanalz (c_Event_Oknows c_Message_Oagent_OSpy v_evs4))) tc_Message_Omsg)} 	: UnifyingResolution(5, 8)[]
10: { ⊢ (c_in (c_Message_Omsg_OCrypt (c_Public_OshrK v_A) (c_Message_Omsg_OMPair v_NA (c_Message_Omsg_OKey v_K))) (c_Message_Oparts (c_insert v_X (c_Event_Oknows c_Message_Oagent_OSpy v_evs4) tc_Message_Omsg)) tc_Message_Omsg)} 	: Axiom()[]
11: {(c_in W (c_Message_Oparts (c_insert U V tc_Message_Omsg)) tc_Message_Omsg), (c_in U (c_Message_Osynth (c_Message_Oanalz V)) tc_Message_Omsg) ⊢ (c_in W (c_union (c_Message_Osynth (c_Message_Oanalz V)) (c_Message_Oparts V) tc_Message_Omsg) tc_Message_Omsg)} 	: Axiom()[]
12: {(c_in v_X (c_Message_Osynth (c_Message_Oanalz (c_Event_Oknows c_Message_Oagent_OSpy v_evs4))) tc_Message_Omsg) ⊢ (c_in (c_Message_Omsg_OCrypt (c_Public_OshrK v_A) (c_Message_Omsg_OMPair v_NA (c_Message_Omsg_OKey v_K))) (c_union (c_Message_Osynth (c_Message_Oanalz (c_Event_Oknows c_Message_Oagent_OSpy v_evs4))) (c_Message_Oparts (c_Event_Oknows c_Message_Oagent_OSpy v_evs4)) tc_Message_Omsg) tc_Message_Omsg)} 	: UnifyingResolution(10, 11)[]
13: {(c_in U (c_union V W X) X) ⊢ (c_in U W X), (c_in U V X)} 	: Axiom()[]
14: {(c_in (c_Message_Omsg_OCrypt (c_Public_OshrK v_A) (c_Message_Omsg_OMPair v_NA (c_Message_Omsg_OKey v_K))) (c_Message_Oparts (c_Event_Oknows c_Message_Oagent_OSpy v_evs4)) tc_Message_Omsg) ⊢ } 	: Axiom()[]
15: {(c_in (c_Message_Omsg_OCrypt (c_Public_OshrK v_A) (c_Message_Omsg_OMPair v_NA (c_Message_Omsg_OKey v_K))) (c_union V (c_Message_Oparts (c_Event_Oknows c_Message_Oagent_OSpy v_evs4)) tc_Message_Omsg) tc_Message_Omsg) ⊢ (c_in (c_Message_Omsg_OCrypt (c_Public_OshrK v_A) (c_Message_Omsg_OMPair v_NA (c_Message_Omsg_OKey v_K))) V tc_Message_Omsg)} 	: UnifyingResolution(13, 14)[]
16: {(c_in v_X (c_Message_Osynth (c_Message_Oanalz (c_Event_Oknows c_Message_Oagent_OSpy v_evs4))) tc_Message_Omsg) ⊢ (c_in (c_Message_Omsg_OCrypt (c_Public_OshrK v_A) (c_Message_Omsg_OMPair v_NA (c_Message_Omsg_OKey v_K))) (c_Message_Osynth (c_Message_Oanalz (c_Event_Oknows c_Message_Oagent_OSpy v_evs4))) tc_Message_Omsg)} 	: UnifyingResolution(12, 15)[]
17: {(c_in (c_Message_Omsg_OCrypt U V) (c_Message_Osynth W) tc_Message_Omsg) ⊢ (c_in (c_Message_Omsg_OCrypt U V) W tc_Message_Omsg), (c_in (c_Message_Omsg_OKey U) W tc_Message_Omsg)} 	: Axiom()[]
18: {(c_in v_X (c_Message_Osynth (c_Message_Oanalz (c_Event_Oknows c_Message_Oagent_OSpy v_evs4))) tc_Message_Omsg) ⊢ (c_in (c_Message_Omsg_OCrypt (c_Public_OshrK v_A) (c_Message_Omsg_OMPair v_NA (c_Message_Omsg_OKey v_K))) (c_Message_Oanalz (c_Event_Oknows c_Message_Oagent_OSpy v_evs4)) tc_Message_Omsg), (c_in (c_Message_Omsg_OKey (c_Public_OshrK v_A)) (c_Message_Oanalz (c_Event_Oknows c_Message_Oagent_OSpy v_evs4)) tc_Message_Omsg)} 	: UnifyingResolution(16, 17)[]
19: {(c_in U (c_Message_Oanalz V) tc_Message_Omsg) ⊢ (c_in U (c_Message_Oparts V) tc_Message_Omsg)} 	: Axiom()[]
20: {(c_in (c_Message_Omsg_OCrypt (c_Public_OshrK v_A) (c_Message_Omsg_OMPair v_NA (c_Message_Omsg_OKey v_K))) (c_Message_Oanalz (c_Event_Oknows c_Message_Oagent_OSpy v_evs4)) tc_Message_Omsg) ⊢ } 	: UnifyingResolution(19, 14)[]
21: {(c_in v_X (c_Message_Osynth (c_Message_Oanalz (c_Event_Oknows c_Message_Oagent_OSpy v_evs4))) tc_Message_Omsg) ⊢ (c_in (c_Message_Omsg_OKey (c_Public_OshrK v_A)) (c_Message_Oanalz (c_Event_Oknows c_Message_Oagent_OSpy v_evs4)) tc_Message_Omsg)} 	: UnifyingResolution(18, 20)[]
22: { ⊢ (c_in v_evs4 c_OtwayRees_Ootway (tc_List_Olist tc_Event_Oevent))} 	: Axiom()[]
23: {(c_in (c_Message_Omsg_OKey (c_Public_OshrK V)) (c_Message_Oparts (c_Event_Oknows c_Message_Oagent_OSpy U)) tc_Message_Omsg), (c_in U c_OtwayRees_Ootway (tc_List_Olist tc_Event_Oevent)) ⊢ (c_in V c_Event_Obad tc_Message_Oagent)} 	: Axiom()[]
24: {(c_in v_A c_Event_Obad tc_Message_Oagent) ⊢ } 	: Axiom()[]
25: {(c_in (c_Message_Omsg_OKey (c_Public_OshrK v_A)) (c_Message_Oparts (c_Event_Oknows c_Message_Oagent_OSpy U)) tc_Message_Omsg), (c_in U c_OtwayRees_Ootway (tc_List_Olist tc_Event_Oevent)) ⊢ } 	: UnifyingResolution(23, 24)[]
26: {(c_in (c_Message_Omsg_OKey (c_Public_OshrK v_A)) (c_Message_Oparts (c_Event_Oknows c_Message_Oagent_OSpy v_evs4)) tc_Message_Omsg) ⊢ } 	: UnifyingResolution(22, 25)[]
27: {(c_in (c_Message_Omsg_OKey (c_Public_OshrK v_A)) (c_Message_Oanalz (c_Event_Oknows c_Message_Oagent_OSpy v_evs4)) tc_Message_Omsg) ⊢ } 	: UnifyingResolution(19, 26)[]
28: {(c_in v_X (c_Message_Osynth (c_Message_Oanalz (c_Event_Oknows c_Message_Oagent_OSpy v_evs4))) tc_Message_Omsg) ⊢ } 	: UnifyingResolution(21, 27)[]
29: { ⊢ } 	: UnifyingResolution(9, 28)[]

