1: { ⊢ (subpopulations first_movers efficient_producers sk1 sk2)} 	: Axiom()[]
2: { ⊢ (environment sk1)} 	: Axiom()[]
3: {(subpopulations first_movers efficient_producers U V), (environment U) ⊢ (in_environment U V)} 	: Axiom()[]
4: {(subpopulations first_movers efficient_producers sk1 V) ⊢ (in_environment sk1 V)} 	: UnifyingResolution(2, 3)[]
5: { ⊢ (in_environment sk1 sk2)} 	: UnifyingResolution(1, 4)[]
6: { ⊢ (outcompetes first_movers efficient_producers sk2)} 	: Axiom()[]
7: { ⊢ (greater (resilience efficient_producers) (resilience first_movers))} 	: Axiom()[]
8: {(subpopulations V W U X), (environment U) ⊢ (subpopulations W V U X)} 	: Axiom()[]
9: {(subpopulations V W sk1 X) ⊢ (subpopulations W V sk1 X)} 	: UnifyingResolution(2, 8)[]
10: { ⊢ (subpopulations efficient_producers first_movers sk1 sk2)} 	: UnifyingResolution(1, 9)[]
11: {(subpopulations W V U X), (outcompetes V W X), (environment U) ⊢ (greater zero (growth_rate W X))} 	: Axiom()[]
12: {(subpopulations W V sk1 X), (outcompetes V W X) ⊢ (greater zero (growth_rate W X))} 	: UnifyingResolution(2, 11)[]
13: {(outcompetes first_movers efficient_producers sk2) ⊢ (greater zero (growth_rate efficient_producers sk2))} 	: UnifyingResolution(10, 12)[]
14: {(greater (resilience W) (resilience X)), (greater zero (growth_rate W V)), (in_environment U V), (environment U) ⊢ (greater zero (growth_rate X V))} 	: Axiom()[]
15: {(greater (resilience W) (resilience X)), (greater zero (growth_rate W V)), (in_environment sk1 V) ⊢ (greater zero (growth_rate X V))} 	: UnifyingResolution(2, 14)[]
16: {(outcompetes first_movers efficient_producers sk2), (greater (resilience efficient_producers) (resilience X)), (in_environment sk1 sk2) ⊢ (greater zero (growth_rate X sk2))} 	: UnifyingResolution(13, 15)[]
17: {(outcompetes first_movers efficient_producers sk2), (in_environment sk1 sk2) ⊢ (greater zero (growth_rate first_movers sk2))} 	: UnifyingResolution(7, 16)[]
18: {(subpopulations W V U X), (outcompetes V W X), (environment U) ⊢ (greater_or_equal (growth_rate V X) zero)} 	: Axiom()[]
19: {(subpopulations W V sk1 X), (outcompetes V W X) ⊢ (greater_or_equal (growth_rate V X) zero)} 	: UnifyingResolution(2, 18)[]
20: {(outcompetes first_movers efficient_producers sk2) ⊢ (greater_or_equal (growth_rate first_movers sk2) zero)} 	: UnifyingResolution(10, 19)[]
21: {(greater_or_equal (growth_rate U V) zero), (greater zero (growth_rate U V)) ⊢ } 	: Axiom()[]
22: {(outcompetes first_movers efficient_producers sk2), (greater zero (growth_rate first_movers sk2)) ⊢ } 	: UnifyingResolution(20, 21)[]
23: {(outcompetes first_movers efficient_producers sk2), (in_environment sk1 sk2), (outcompetes first_movers efficient_producers sk2) ⊢ } 	: UnifyingResolution(17, 22)[]
24: {(in_environment sk1 sk2), (outcompetes first_movers efficient_producers sk2) ⊢ } 	: Contraction(23)[]
25: {(in_environment sk1 sk2) ⊢ } 	: UnifyingResolution(6, 24)[]
26: { ⊢ } 	: UnifyingResolution(5, 25)[]

