1: { ⊢ (iext uri_rdf_type uri_ex_name uri_ex_PersonAttribute)} 	: Axiom()[]
2: {(iext uri_rdf_type U V) ⊢ (icext V U)} 	: Axiom()[]
3: { ⊢ (icext uri_ex_PersonAttribute uri_ex_name)} 	: UnifyingResolution(1, 2)[]
4: { ⊢ (iext uri_rdf_rest skc13 uri_rdf_nil)} 	: Axiom()[]
5: { ⊢ (iext uri_owl_intersectionOf uri_ex_PersonAttribute skc15)} 	: Axiom()[]
6: { ⊢ (iext uri_rdf_first skc15 uri_owl_DatatypeProperty)} 	: Axiom()[]
7: { ⊢ (iext uri_rdf_rest skc15 skc14)} 	: Axiom()[]
8: { ⊢ (iext uri_rdf_first skc14 uri_owl_FunctionalProperty)} 	: Axiom()[]
9: { ⊢ (iext uri_rdf_rest skc14 skc13)} 	: Axiom()[]
10: { ⊢ (iext uri_rdf_first skc13 skc12)} 	: Axiom()[]
11: {(iext uri_rdf_rest W uri_rdf_nil), (iext uri_owl_intersectionOf U X1), (iext uri_rdf_first X1 X2), (iext uri_rdf_rest X1 Y), (iext uri_rdf_first Y Z), (iext uri_rdf_rest Y W), (iext uri_rdf_first W X), (icext U V) ⊢ (SkP0 X Z V X2)} 	: Axiom()[]
12: {(iext uri_rdf_rest skc13 uri_rdf_nil), (iext uri_owl_intersectionOf U X1), (iext uri_rdf_first X1 X2), (iext uri_rdf_rest X1 Y), (iext uri_rdf_first Y Z), (iext uri_rdf_rest Y skc13), (icext U V) ⊢ (SkP0 skc12 Z V X2)} 	: UnifyingResolution(10, 11)[]
13: {(iext uri_rdf_rest skc13 uri_rdf_nil), (iext uri_owl_intersectionOf U X1), (iext uri_rdf_first X1 X2), (iext uri_rdf_rest X1 skc14), (iext uri_rdf_first skc14 Z), (icext U V) ⊢ (SkP0 skc12 Z V X2)} 	: UnifyingResolution(9, 12)[]
14: {(iext uri_rdf_rest skc13 uri_rdf_nil), (iext uri_owl_intersectionOf U X1), (iext uri_rdf_first X1 X2), (iext uri_rdf_rest X1 skc14), (icext U V) ⊢ (SkP0 skc12 uri_owl_FunctionalProperty V X2)} 	: UnifyingResolution(8, 13)[]
15: {(iext uri_rdf_rest skc13 uri_rdf_nil), (iext uri_owl_intersectionOf U skc15), (iext uri_rdf_first skc15 X2), (icext U V) ⊢ (SkP0 skc12 uri_owl_FunctionalProperty V X2)} 	: UnifyingResolution(7, 14)[]
16: {(iext uri_rdf_rest skc13 uri_rdf_nil), (iext uri_owl_intersectionOf U skc15), (icext U V) ⊢ (SkP0 skc12 uri_owl_FunctionalProperty V uri_owl_DatatypeProperty)} 	: UnifyingResolution(6, 15)[]
17: {(iext uri_rdf_rest skc13 uri_rdf_nil), (icext uri_ex_PersonAttribute V) ⊢ (SkP0 skc12 uri_owl_FunctionalProperty V uri_owl_DatatypeProperty)} 	: UnifyingResolution(5, 16)[]
18: {(SkP0 U V W X) ⊢ (icext U W)} 	: Axiom()[]
19: {(icext uri_ex_PersonAttribute W), (iext uri_rdf_rest skc13 uri_rdf_nil) ⊢ (icext skc12 W)} 	: UnifyingResolution(17, 18)[]
20: {(icext uri_ex_PersonAttribute W) ⊢ (icext skc12 W)} 	: UnifyingResolution(4, 19)[]
21: { ⊢ (icext skc12 uri_ex_name)} 	: UnifyingResolution(3, 20)[]
22: { ⊢ (iext uri_owl_onProperty skc12 uri_rdfs_domain)} 	: Axiom()[]
23: { ⊢ (iext uri_owl_hasValue skc12 uri_foaf_Person)} 	: Axiom()[]
24: {(iext uri_owl_onProperty U X), (iext uri_owl_hasValue U W), (icext U V) ⊢ (iext X V W)} 	: Axiom()[]
25: {(iext uri_owl_onProperty skc12 X), (icext skc12 V) ⊢ (iext X V uri_foaf_Person)} 	: UnifyingResolution(23, 24)[]
26: {(icext skc12 V) ⊢ (iext uri_rdfs_domain V uri_foaf_Person)} 	: UnifyingResolution(22, 25)[]
27: { ⊢ (iext uri_ex_name uri_ex_alice (literal_plain dat_str_alice))} 	: Axiom()[]
28: {(iext uri_rdfs_domain U X), (iext U V W) ⊢ (icext X V)} 	: Axiom()[]
29: {(iext uri_rdfs_domain uri_ex_name X) ⊢ (icext X uri_ex_alice)} 	: UnifyingResolution(27, 28)[]
30: {(icext skc12 uri_ex_name) ⊢ (icext uri_foaf_Person uri_ex_alice)} 	: UnifyingResolution(26, 29)[]
31: {(SkP0 U V W X) ⊢ (icext V W)} 	: Axiom()[]
32: {(icext uri_ex_PersonAttribute W), (iext uri_rdf_rest skc13 uri_rdf_nil) ⊢ (icext uri_owl_FunctionalProperty W)} 	: UnifyingResolution(17, 31)[]
33: {(icext uri_ex_PersonAttribute W) ⊢ (icext uri_owl_FunctionalProperty W)} 	: UnifyingResolution(4, 32)[]
34: {(icext U V) ⊢ (iext uri_rdf_type V U)} 	: Axiom()[]
35: {(iext uri_rdf_type uri_ex_name uri_owl_FunctionalProperty), (iext uri_rdf_type uri_ex_alice uri_foaf_Person) ⊢ } 	: Axiom()[]
36: {(icext uri_owl_FunctionalProperty uri_ex_name), (iext uri_rdf_type uri_ex_alice uri_foaf_Person) ⊢ } 	: UnifyingResolution(34, 35)[]
37: {(icext uri_foaf_Person uri_ex_alice), (icext uri_owl_FunctionalProperty uri_ex_name) ⊢ } 	: UnifyingResolution(34, 36)[]
38: {(icext uri_ex_PersonAttribute uri_ex_name), (icext uri_foaf_Person uri_ex_alice) ⊢ } 	: UnifyingResolution(33, 37)[]
39: {(icext skc12 uri_ex_name), (icext uri_ex_PersonAttribute uri_ex_name) ⊢ } 	: UnifyingResolution(30, 38)[]
40: {(icext skc12 uri_ex_name) ⊢ } 	: UnifyingResolution(3, 39)[]
41: { ⊢ } 	: UnifyingResolution(21, 40)[]

