1: { ⊢ (subpopulations first_movers efficient_producers skc3 skc2)} 	: Axiom()[]
2: { ⊢ (environment skc3)} 	: Axiom()[]
3: {(subpopulations first_movers efficient_producers U V), (environment U) ⊢ (in_environment U V)} 	: Axiom()[]
4: {(subpopulations first_movers efficient_producers skc3 V) ⊢ (in_environment skc3 V)} 	: UnifyingResolution(2, 3)[]
5: { ⊢ (in_environment skc3 skc2)} 	: UnifyingResolution(1, 4)[]
6: { ⊢ (outcompetes first_movers efficient_producers skc2)} 	: Axiom()[]
7: {(subpopulations first_movers efficient_producers U V), (environment U) ⊢ (subpopulations efficient_producers first_movers U V)} 	: Axiom()[]
8: {(subpopulations first_movers efficient_producers skc3 V) ⊢ (subpopulations efficient_producers first_movers skc3 V)} 	: UnifyingResolution(2, 7)[]
9: { ⊢ (subpopulations efficient_producers first_movers skc3 skc2)} 	: UnifyingResolution(1, 8)[]
10: {(subpopulations V W U X), (environment U) ⊢ (greater_or_equal (growth_rate V X) zero), (greater zero (growth_rate V X))} 	: Axiom()[]
11: {(subpopulations V W skc3 X) ⊢ (greater_or_equal (growth_rate V X) zero), (greater zero (growth_rate V X))} 	: UnifyingResolution(2, 10)[]
12: { ⊢ (greater_or_equal (growth_rate efficient_producers skc2) zero), (greater zero (growth_rate efficient_producers skc2))} 	: UnifyingResolution(9, 11)[]
13: {(greater zero (growth_rate U V)) ⊢ (subpopulations U W X V)} 	: Axiom()[]
14: { ⊢ (greater_or_equal (growth_rate efficient_producers skc2) zero), (subpopulations efficient_producers W X skc2)} 	: UnifyingResolution(12, 13)[]
15: {(subpopulations W V U X), (outcompetes V W X), (environment U) ⊢ (greater_or_equal (growth_rate V X) zero)} 	: Axiom()[]
16: {(subpopulations W V skc3 X), (outcompetes V W X) ⊢ (greater_or_equal (growth_rate V X) zero)} 	: UnifyingResolution(2, 15)[]
17: {(outcompetes V efficient_producers skc2) ⊢ (greater_or_equal (growth_rate efficient_producers skc2) zero), (greater_or_equal (growth_rate V skc2) zero)} 	: UnifyingResolution(14, 16)[]
18: { ⊢ (greater_or_equal (growth_rate efficient_producers skc2) zero), (greater_or_equal (growth_rate first_movers skc2) zero)} 	: UnifyingResolution(6, 17)[]
19: { ⊢ (greater (resilience efficient_producers) (resilience first_movers))} 	: Axiom()[]
20: {(greater (resilience W) (resilience X)), (greater zero (growth_rate W V)), (in_environment U V), (environment U) ⊢ (greater zero (growth_rate X V))} 	: Axiom()[]
21: {(greater (resilience W) (resilience X)), (greater zero (growth_rate W V)), (in_environment skc3 V) ⊢ (greater zero (growth_rate X V))} 	: UnifyingResolution(2, 20)[]
22: {(greater (resilience efficient_producers) (resilience X)), (in_environment skc3 skc2) ⊢ (greater_or_equal (growth_rate efficient_producers skc2) zero), (greater zero (growth_rate X skc2))} 	: UnifyingResolution(12, 21)[]
23: {(in_environment skc3 skc2) ⊢ (greater_or_equal (growth_rate efficient_producers skc2) zero), (greater zero (growth_rate first_movers skc2))} 	: UnifyingResolution(19, 22)[]
24: {(greater_or_equal (growth_rate U V) zero), (greater zero (growth_rate U V)) ⊢ } 	: Axiom()[]
25: {(in_environment skc3 skc2), (greater_or_equal (growth_rate first_movers skc2) zero) ⊢ (greater_or_equal (growth_rate efficient_producers skc2) zero)} 	: UnifyingResolution(23, 24)[]
26: {(in_environment skc3 skc2) ⊢ (greater_or_equal (growth_rate efficient_producers skc2) zero), (greater_or_equal (growth_rate efficient_producers skc2) zero)} 	: UnifyingResolution(18, 25)[]
27: {(in_environment skc3 skc2) ⊢ (greater_or_equal (growth_rate efficient_producers skc2) zero)} 	: Contraction(26)[]
28: {(subpopulations W V U X), (outcompetes V W X), (environment U) ⊢ (greater zero (growth_rate W X))} 	: Axiom()[]
29: {(subpopulations W V skc3 X), (outcompetes V W X) ⊢ (greater zero (growth_rate W X))} 	: UnifyingResolution(2, 28)[]
30: {(outcompetes first_movers efficient_producers skc2) ⊢ (greater zero (growth_rate efficient_producers skc2))} 	: UnifyingResolution(9, 29)[]
31: {(outcompetes first_movers efficient_producers skc2), (greater_or_equal (growth_rate efficient_producers skc2) zero) ⊢ } 	: UnifyingResolution(30, 24)[]
32: {(in_environment skc3 skc2), (outcompetes first_movers efficient_producers skc2) ⊢ } 	: UnifyingResolution(27, 31)[]
33: {(in_environment skc3 skc2) ⊢ } 	: UnifyingResolution(6, 32)[]
34: { ⊢ } 	: UnifyingResolution(5, 33)[]

