1: { ⊢ (truth (isa U knight)), (truth (isa U knave))} 	: Axiom()[]
2: { ⊢ (reply U V yes), (reply U V no)} 	: Axiom()[]
3: {(reply asked (or__dfg (isa asked knight) (isa other knight)) W), (truth (isa asked V)), (truth (isa other U)) ⊢ } 	: Axiom()[]
4: {(truth (isa asked V)), (truth (isa other U)) ⊢ (reply asked (or__dfg (isa asked knight) (isa other knight)) no)} 	: UnifyingResolutionMRR(2, 3)[]
5: {(truth (isa asked V)) ⊢ (truth (isa other knave)), (reply asked (or__dfg (isa asked knight) (isa other knight)) no)} 	: UnifyingResolutionMRR(1, 4)[]
6: { ⊢ (truth (isa asked knave)), (truth (isa other knave)), (reply asked (or__dfg (isa asked knight) (isa other knight)) no)} 	: UnifyingResolutionMRR(1, 5)[]
7: {(truth (isa asked V)), (truth (isa other U)) ⊢ (truth (isa asked knave)), (truth (isa other knave))} 	: UnifyingResolutionMRR(6, 3)[]
8: {(truth (isa asked V)) ⊢ (truth (isa other knave)), (truth (isa asked knave)), (truth (isa other knave))} 	: UnifyingResolutionMRR(1, 7)[]
9: {(truth (isa asked V)) ⊢ (truth (isa other knave)), (truth (isa asked knave))} 	: Contraction(8)[]
10: { ⊢ (truth (isa asked knave)), (truth (isa other knave)), (truth (isa asked knave))} 	: UnifyingResolutionMRR(1, 9)[]
11: { ⊢ (truth (isa other knave)), (truth (isa asked knave))} 	: Contraction(10)[]
12: { ⊢ (truth (isa other knave)), (truth (isa other knave)), (reply asked (or__dfg (isa asked knight) (isa other knight)) no)} 	: UnifyingResolutionMRR(11, 5)[]
13: {(truth (isa asked V)), (truth (isa other U)) ⊢ (truth (isa other knave)), (truth (isa other knave))} 	: UnifyingResolutionMRR(12, 3)[]
14: {(truth (isa other W)), (truth (isa asked NEW1)) ⊢ (truth (isa other knave))} 	: Contraction(13)[]
15: {(truth (isa asked NEW1)) ⊢ (truth (isa other knave)), (truth (isa other knave))} 	: UnifyingResolutionMRR(1, 14)[]
16: { ⊢ (truth (isa other knave)), (truth (isa other knave)), (truth (isa other knave))} 	: UnifyingResolutionMRR(11, 15)[]
17: { ⊢ (truth (isa other knave))} 	: Contraction(16)[]
18: {(truth (isa asked V)), (truth (isa other knave)) ⊢ (reply asked (or__dfg (isa asked knight) (isa other knight)) no)} 	: FOSubstitution(4)[]
19: {(truth (isa other knave)) ⊢ (truth (isa asked knave)), (reply asked (or__dfg (isa asked knight) (isa other knight)) no)} 	: UnifyingResolutionMRR(1, 18)[]
20: {(truth (isa other knave)), (truth (isa asked V)), (truth (isa other U)) ⊢ (truth (isa asked knave))} 	: UnifyingResolutionMRR(19, 3)[]
21: {(truth (isa other knave)), (truth (isa asked W)) ⊢ (truth (isa asked knave))} 	: Contraction(20)[]
22: {(truth (isa other knave)) ⊢ (truth (isa asked knave)), (truth (isa asked knave))} 	: UnifyingResolutionMRR(1, 21)[]
23: {(truth (isa other knave)) ⊢ (truth (isa asked knave))} 	: Contraction(22)[]
24: {(truth (isa asked knave)), (truth (isa other U)) ⊢ (reply asked (or__dfg (isa asked knight) (isa other knight)) no)} 	: FOSubstitution(4)[]
25: {(truth (isa other NEW1)), (truth (isa asked knave)), (truth (isa asked V)), (truth (isa other U)) ⊢ } 	: UnifyingResolutionMRR(24, 3)[]
26: {(truth (isa other U)), (truth (isa asked knave)) ⊢ } 	: Contraction(25)[]
27: {(truth (isa other knave)), (truth (isa other U)) ⊢ } 	: UnifyingResolution(23, 26)[]
28: {(truth (isa other knave)) ⊢ } 	: Contraction(27)[]
29: { ⊢ } 	: UnifyingResolution(17, 28)[]

