1: { ⊢ (iext uri_rdf_type uri_ex_bob uri_ex_Person)} 	: Axiom()[]
2: {(iext uri_rdf_type U V) ⊢ (icext V U)} 	: Axiom()[]
3: { ⊢ (icext uri_ex_Person uri_ex_bob)} 	: UnifyingResolution(1, 2)[]
4: { ⊢ (iext uri_rdfs_subClassOf uri_ex_Person skc7)} 	: Axiom()[]
5: {(iext uri_rdfs_subClassOf U W), (icext U V) ⊢ (icext W V)} 	: Axiom()[]
6: {(icext uri_ex_Person V) ⊢ (icext skc7 V)} 	: UnifyingResolution(4, 5)[]
7: { ⊢ (icext skc7 uri_ex_bob)} 	: UnifyingResolution(3, 6)[]
8: { ⊢ (iext uri_rdf_type uri_ex_hasAncestor uri_owl_TransitiveProperty)} 	: Axiom()[]
9: { ⊢ (icext uri_owl_TransitiveProperty uri_ex_hasAncestor)} 	: UnifyingResolution(8, 2)[]
10: { ⊢ (iext uri_ex_hasAncestor uri_ex_alice uri_ex_bob)} 	: Axiom()[]
11: { ⊢ (iext uri_owl_onProperty skc7 uri_ex_hasAncestor)} 	: Axiom()[]
12: { ⊢ (iext uri_owl_minCardinality skc7 (literal_typed dat_str_1 uri_xsd_nonNegativeInteger))} 	: Axiom()[]
13: {(iext uri_owl_minCardinality U (literal_typed dat_str_1 uri_xsd_nonNegativeInteger)), (iext uri_owl_onProperty U W), (icext U V) ⊢ (iext W V (skf5 V W))} 	: Axiom()[]
14: {(iext uri_owl_onProperty skc7 W), (icext skc7 V) ⊢ (iext W V (skf5 V W))} 	: UnifyingResolution(12, 13)[]
15: {(iext U X V), (iext U V W), (icext uri_owl_TransitiveProperty U) ⊢ (iext U X W)} 	: Axiom()[]
16: {(icext skc7 V), (iext uri_owl_onProperty skc7 U), (iext U X V), (icext uri_owl_TransitiveProperty U) ⊢ (iext U X (skf5 V U))} 	: UnifyingResolution(14, 15)[]
17: {(iext uri_ex_hasAncestor uri_ex_bob U), (iext uri_ex_hasAncestor uri_ex_alice U) ⊢ } 	: Axiom()[]
18: {(iext uri_owl_onProperty skc7 uri_ex_hasAncestor), (icext skc7 uri_ex_bob), (iext uri_ex_hasAncestor uri_ex_alice (skf5 uri_ex_bob uri_ex_hasAncestor)) ⊢ } 	: UnifyingResolution(14, 17)[]
19: {(icext skc7 uri_ex_bob), (iext uri_owl_onProperty skc7 uri_ex_hasAncestor), (iext uri_ex_hasAncestor uri_ex_alice uri_ex_bob), (icext uri_owl_TransitiveProperty uri_ex_hasAncestor), (iext uri_owl_onProperty skc7 uri_ex_hasAncestor), (icext skc7 uri_ex_bob) ⊢ } 	: UnifyingResolution(16, 18)[]
20: {(iext uri_ex_hasAncestor uri_ex_alice uri_ex_bob), (icext uri_owl_TransitiveProperty uri_ex_hasAncestor), (iext uri_owl_onProperty skc7 uri_ex_hasAncestor), (icext skc7 uri_ex_bob) ⊢ } 	: Contraction(19)[]
21: {(iext uri_ex_hasAncestor uri_ex_alice uri_ex_bob), (icext uri_owl_TransitiveProperty uri_ex_hasAncestor), (icext skc7 uri_ex_bob) ⊢ } 	: UnifyingResolution(11, 20)[]
22: {(icext uri_owl_TransitiveProperty uri_ex_hasAncestor), (icext skc7 uri_ex_bob) ⊢ } 	: UnifyingResolution(10, 21)[]
23: {(icext skc7 uri_ex_bob) ⊢ } 	: UnifyingResolution(9, 22)[]
24: { ⊢ } 	: UnifyingResolution(7, 23)[]

