1: { ⊢ (c_in (c_Event_Oevent_OGets v_B (c_Message_Omsg_OMPair (c_Message_Omsg_ONonce v_NA) (c_Message_Omsg_OMPair v_X (c_Message_Omsg_OCrypt (c_Public_OshrK v_B) (c_Message_Omsg_OMPair (c_Message_Omsg_ONonce v_NB) (c_Message_Omsg_OKey v_K)))))) (c_List_Oset v_evs4 tc_Event_Oevent) tc_Event_Oevent)} 	: Axiom()[]
2: { ⊢ (c_in v_evs4 c_OtwayRees_Ootway (tc_List_Olist tc_Event_Oevent))} 	: Axiom()[]
3: {(c_in (c_Event_Oevent_OGets V W) (c_List_Oset U tc_Event_Oevent) tc_Event_Oevent), (c_in U c_OtwayRees_Ootway (tc_List_Olist tc_Event_Oevent)) ⊢ (c_in (c_Event_Oevent_OSays (v_sko__usf V W U) V W) (c_List_Oset U tc_Event_Oevent) tc_Event_Oevent)} 	: Axiom()[]
4: {(c_in (c_Event_Oevent_OGets V W) (c_List_Oset v_evs4 tc_Event_Oevent) tc_Event_Oevent) ⊢ (c_in (c_Event_Oevent_OSays (v_sko__usf V W v_evs4) V W) (c_List_Oset v_evs4 tc_Event_Oevent) tc_Event_Oevent)} 	: UnifyingResolution(2, 3)[]
5: {(c_in (c_Event_Oevent_OSays U V W) (c_List_Oset X tc_Event_Oevent) tc_Event_Oevent) ⊢ (c_in W (c_Message_Oanalz (c_Event_Oknows c_Message_Oagent_OSpy X)) tc_Message_Omsg)} 	: Axiom()[]
6: {(c_in (c_Event_Oevent_OGets V W) (c_List_Oset v_evs4 tc_Event_Oevent) tc_Event_Oevent) ⊢ (c_in W (c_Message_Oanalz (c_Event_Oknows c_Message_Oagent_OSpy v_evs4)) tc_Message_Omsg)} 	: UnifyingResolution(4, 5)[]
7: { ⊢ (c_in (c_Message_Omsg_OMPair (c_Message_Omsg_ONonce v_NA) (c_Message_Omsg_OMPair v_X (c_Message_Omsg_OCrypt (c_Public_OshrK v_B) (c_Message_Omsg_OMPair (c_Message_Omsg_ONonce v_NB) (c_Message_Omsg_OKey v_K))))) (c_Message_Oanalz (c_Event_Oknows c_Message_Oagent_OSpy v_evs4)) tc_Message_Omsg)} 	: UnifyingResolution(1, 6)[]
8: {(c_in U V tc_Message_Omsg) ⊢ (c_in U (c_Message_Osynth V) tc_Message_Omsg)} 	: Axiom()[]
9: {(c_in (c_Message_Omsg_OMPair U V) (c_Message_Osynth (c_Message_Oanalz W)) tc_Message_Omsg) ⊢ (c_in V (c_Message_Osynth (c_Message_Oanalz W)) tc_Message_Omsg)} 	: Axiom()[]
10: {(c_in (c_Message_Omsg_OMPair U V) (c_Message_Oanalz W) tc_Message_Omsg) ⊢ (c_in V (c_Message_Osynth (c_Message_Oanalz W)) tc_Message_Omsg)} 	: UnifyingResolution(8, 9)[]
11: { ⊢ (c_in (c_Message_Omsg_OMPair v_X (c_Message_Omsg_OCrypt (c_Public_OshrK v_B) (c_Message_Omsg_OMPair (c_Message_Omsg_ONonce v_NB) (c_Message_Omsg_OKey v_K)))) (c_Message_Osynth (c_Message_Oanalz (c_Event_Oknows c_Message_Oagent_OSpy v_evs4))) tc_Message_Omsg)} 	: UnifyingResolution(7, 10)[]
12: {(c_in (c_Message_Omsg_OMPair U V) (c_Message_Osynth (c_Message_Oanalz W)) tc_Message_Omsg) ⊢ (c_in U (c_Message_Osynth (c_Message_Oanalz W)) tc_Message_Omsg)} 	: Axiom()[]
13: { ⊢ (c_in v_X (c_Message_Osynth (c_Message_Oanalz (c_Event_Oknows c_Message_Oagent_OSpy v_evs4))) tc_Message_Omsg)} 	: UnifyingResolution(11, 12)[]
14: { ⊢ (c_in (c_Message_Omsg_OKey (c_Public_OshrK v_A)) (c_Message_Oparts (c_insert v_X (c_Event_Oknows c_Message_Oagent_OSpy v_evs4) tc_Message_Omsg)) tc_Message_Omsg), (c_in v_A c_Event_Obad tc_Message_Oagent)} 	: Axiom()[]
15: {(c_in W (c_Message_Oparts (c_insert U V tc_Message_Omsg)) tc_Message_Omsg), (c_in U (c_Message_Osynth (c_Message_Oanalz V)) tc_Message_Omsg) ⊢ (c_in W (c_union (c_Message_Osynth (c_Message_Oanalz V)) (c_Message_Oparts V) tc_Message_Omsg) tc_Message_Omsg)} 	: Axiom()[]
16: {(c_in v_X (c_Message_Osynth (c_Message_Oanalz (c_Event_Oknows c_Message_Oagent_OSpy v_evs4))) tc_Message_Omsg) ⊢ (c_in v_A c_Event_Obad tc_Message_Oagent), (c_in (c_Message_Omsg_OKey (c_Public_OshrK v_A)) (c_union (c_Message_Osynth (c_Message_Oanalz (c_Event_Oknows c_Message_Oagent_OSpy v_evs4))) (c_Message_Oparts (c_Event_Oknows c_Message_Oagent_OSpy v_evs4)) tc_Message_Omsg) tc_Message_Omsg)} 	: UnifyingResolution(14, 15)[]
17: {(c_in U (c_union V W X) X) ⊢ (c_in U W X), (c_in U V X)} 	: Axiom()[]
18: {(c_in v_X (c_Message_Osynth (c_Message_Oanalz (c_Event_Oknows c_Message_Oagent_OSpy v_evs4))) tc_Message_Omsg) ⊢ (c_in v_A c_Event_Obad tc_Message_Oagent), (c_in (c_Message_Omsg_OKey (c_Public_OshrK v_A)) (c_Message_Oparts (c_Event_Oknows c_Message_Oagent_OSpy v_evs4)) tc_Message_Omsg), (c_in (c_Message_Omsg_OKey (c_Public_OshrK v_A)) (c_Message_Osynth (c_Message_Oanalz (c_Event_Oknows c_Message_Oagent_OSpy v_evs4))) tc_Message_Omsg)} 	: UnifyingResolution(16, 17)[]
19: {(c_in (c_Message_Omsg_OKey U) (c_Message_Osynth V) tc_Message_Omsg) ⊢ (c_in (c_Message_Omsg_OKey U) V tc_Message_Omsg)} 	: Axiom()[]
20: {(c_in v_X (c_Message_Osynth (c_Message_Oanalz (c_Event_Oknows c_Message_Oagent_OSpy v_evs4))) tc_Message_Omsg) ⊢ (c_in v_A c_Event_Obad tc_Message_Oagent), (c_in (c_Message_Omsg_OKey (c_Public_OshrK v_A)) (c_Message_Oparts (c_Event_Oknows c_Message_Oagent_OSpy v_evs4)) tc_Message_Omsg), (c_in (c_Message_Omsg_OKey (c_Public_OshrK v_A)) (c_Message_Oanalz (c_Event_Oknows c_Message_Oagent_OSpy v_evs4)) tc_Message_Omsg)} 	: UnifyingResolution(18, 19)[]
21: {(c_in (c_Message_Omsg_OKey (c_Public_OshrK v_A)) (c_Message_Oparts (c_Event_Oknows c_Message_Oagent_OSpy v_evs4)) tc_Message_Omsg) ⊢ (c_in v_A c_Event_Obad tc_Message_Oagent)} 	: Axiom()[]
22: {(c_in v_X (c_Message_Osynth (c_Message_Oanalz (c_Event_Oknows c_Message_Oagent_OSpy v_evs4))) tc_Message_Omsg) ⊢ (c_in v_A c_Event_Obad tc_Message_Oagent), (c_in (c_Message_Omsg_OKey (c_Public_OshrK v_A)) (c_Message_Oanalz (c_Event_Oknows c_Message_Oagent_OSpy v_evs4)) tc_Message_Omsg), (c_in v_A c_Event_Obad tc_Message_Oagent)} 	: UnifyingResolution(20, 21)[]
23: {(c_in v_X (c_Message_Osynth (c_Message_Oanalz (c_Event_Oknows c_Message_Oagent_OSpy v_evs4))) tc_Message_Omsg) ⊢ (c_in (c_Message_Omsg_OKey (c_Public_OshrK v_A)) (c_Message_Oanalz (c_Event_Oknows c_Message_Oagent_OSpy v_evs4)) tc_Message_Omsg), (c_in v_A c_Event_Obad tc_Message_Oagent)} 	: Contraction(22)[]
24: {(c_in U (c_Message_Oanalz V) tc_Message_Omsg) ⊢ (c_in U (c_Message_Oparts V) tc_Message_Omsg)} 	: Axiom()[]
25: {(c_in (c_Message_Omsg_OKey (c_Public_OshrK v_A)) (c_Message_Oanalz (c_Event_Oknows c_Message_Oagent_OSpy v_evs4)) tc_Message_Omsg) ⊢ (c_in v_A c_Event_Obad tc_Message_Oagent)} 	: UnifyingResolution(24, 21)[]
26: {(c_in v_X (c_Message_Osynth (c_Message_Oanalz (c_Event_Oknows c_Message_Oagent_OSpy v_evs4))) tc_Message_Omsg) ⊢ (c_in v_A c_Event_Obad tc_Message_Oagent), (c_in v_A c_Event_Obad tc_Message_Oagent)} 	: UnifyingResolution(23, 25)[]
27: {(c_in v_X (c_Message_Osynth (c_Message_Oanalz (c_Event_Oknows c_Message_Oagent_OSpy v_evs4))) tc_Message_Omsg) ⊢ (c_in v_A c_Event_Obad tc_Message_Oagent)} 	: Contraction(26)[]
28: { ⊢ (c_in v_A c_Event_Obad tc_Message_Oagent)} 	: UnifyingResolution(13, 27)[]
29: {(c_in U c_Event_Obad tc_Message_Oagent) ⊢ (c_in (c_Message_Omsg_OKey (c_Public_OshrK U)) (c_Event_Oknows c_Message_Oagent_OSpy V) tc_Message_Omsg)} 	: Axiom()[]
30: {(c_in U V W) ⊢ (c_in U (c_insert X V W) W)} 	: Axiom()[]
31: {(c_in U V tc_Message_Omsg) ⊢ (c_in U (c_Message_Oparts V) tc_Message_Omsg)} 	: Axiom()[]
32: {(c_in (c_Message_Omsg_OKey (c_Public_OshrK v_A)) (c_Message_Oparts (c_insert v_X (c_Event_Oknows c_Message_Oagent_OSpy v_evs4) tc_Message_Omsg)) tc_Message_Omsg), (c_in v_A c_Event_Obad tc_Message_Oagent) ⊢ } 	: Axiom()[]
33: {(c_in (c_Message_Omsg_OKey (c_Public_OshrK v_A)) (c_insert v_X (c_Event_Oknows c_Message_Oagent_OSpy v_evs4) tc_Message_Omsg) tc_Message_Omsg), (c_in v_A c_Event_Obad tc_Message_Oagent) ⊢ } 	: UnifyingResolution(31, 32)[]
34: {(c_in (c_Message_Omsg_OKey (c_Public_OshrK v_A)) (c_Event_Oknows c_Message_Oagent_OSpy v_evs4) tc_Message_Omsg), (c_in v_A c_Event_Obad tc_Message_Oagent) ⊢ } 	: UnifyingResolution(30, 33)[]
35: {(c_in v_A c_Event_Obad tc_Message_Oagent), (c_in v_A c_Event_Obad tc_Message_Oagent) ⊢ } 	: UnifyingResolution(29, 34)[]
36: {(c_in v_A c_Event_Obad tc_Message_Oagent) ⊢ } 	: Contraction(35)[]
37: { ⊢ } 	: UnifyingResolution(28, 36)[]

