1: { ⊢ (c_in v_X (c_Message_Osynth (c_Message_Oanalz (c_Event_Oknows c_Message_Oagent_OSpy v_evsf))) tc_Message_Omsg)} 	: Axiom()[]
2: { ⊢ (c_in (c_Message_Omsg_OKey (c_Public_OshrK v_A)) (c_Message_Oparts (c_insert v_X (c_Event_Oknows c_Message_Oagent_OSpy v_evsf) tc_Message_Omsg)) tc_Message_Omsg), (c_in v_A c_Event_Obad tc_Message_Oagent)} 	: Axiom()[]
3: {(c_in W (c_Message_Oparts (c_insert U V tc_Message_Omsg)) tc_Message_Omsg), (c_in U (c_Message_Osynth (c_Message_Oanalz V)) tc_Message_Omsg) ⊢ (c_in W (c_union (c_Message_Osynth (c_Message_Oanalz V)) (c_Message_Oparts V) tc_Message_Omsg) tc_Message_Omsg)} 	: Axiom()[]
4: {(c_in v_X (c_Message_Osynth (c_Message_Oanalz (c_Event_Oknows c_Message_Oagent_OSpy v_evsf))) tc_Message_Omsg) ⊢ (c_in v_A c_Event_Obad tc_Message_Oagent), (c_in (c_Message_Omsg_OKey (c_Public_OshrK v_A)) (c_union (c_Message_Osynth (c_Message_Oanalz (c_Event_Oknows c_Message_Oagent_OSpy v_evsf))) (c_Message_Oparts (c_Event_Oknows c_Message_Oagent_OSpy v_evsf)) tc_Message_Omsg) tc_Message_Omsg)} 	: UnifyingResolution(2, 3)[]
5: {(c_in U (c_union V W X) X) ⊢ (c_in U W X), (c_in U V X)} 	: Axiom()[]
6: {(c_in v_X (c_Message_Osynth (c_Message_Oanalz (c_Event_Oknows c_Message_Oagent_OSpy v_evsf))) tc_Message_Omsg) ⊢ (c_in v_A c_Event_Obad tc_Message_Oagent), (c_in (c_Message_Omsg_OKey (c_Public_OshrK v_A)) (c_Message_Oparts (c_Event_Oknows c_Message_Oagent_OSpy v_evsf)) tc_Message_Omsg), (c_in (c_Message_Omsg_OKey (c_Public_OshrK v_A)) (c_Message_Osynth (c_Message_Oanalz (c_Event_Oknows c_Message_Oagent_OSpy v_evsf))) tc_Message_Omsg)} 	: UnifyingResolution(4, 5)[]
7: {(c_in (c_Message_Omsg_OKey U) (c_Message_Osynth V) tc_Message_Omsg) ⊢ (c_in (c_Message_Omsg_OKey U) V tc_Message_Omsg)} 	: Axiom()[]
8: {(c_in v_X (c_Message_Osynth (c_Message_Oanalz (c_Event_Oknows c_Message_Oagent_OSpy v_evsf))) tc_Message_Omsg) ⊢ (c_in v_A c_Event_Obad tc_Message_Oagent), (c_in (c_Message_Omsg_OKey (c_Public_OshrK v_A)) (c_Message_Oparts (c_Event_Oknows c_Message_Oagent_OSpy v_evsf)) tc_Message_Omsg), (c_in (c_Message_Omsg_OKey (c_Public_OshrK v_A)) (c_Message_Oanalz (c_Event_Oknows c_Message_Oagent_OSpy v_evsf)) tc_Message_Omsg)} 	: UnifyingResolution(6, 7)[]
9: {(c_in U (c_Message_Oanalz V) tc_Message_Omsg) ⊢ (c_in U (c_Message_Oparts V) tc_Message_Omsg)} 	: Axiom()[]
10: {(c_in v_X (c_Message_Osynth (c_Message_Oanalz (c_Event_Oknows c_Message_Oagent_OSpy v_evsf))) tc_Message_Omsg) ⊢ (c_in v_A c_Event_Obad tc_Message_Oagent), (c_in (c_Message_Omsg_OKey (c_Public_OshrK v_A)) (c_Message_Oparts (c_Event_Oknows c_Message_Oagent_OSpy v_evsf)) tc_Message_Omsg), (c_in (c_Message_Omsg_OKey (c_Public_OshrK v_A)) (c_Message_Oparts (c_Event_Oknows c_Message_Oagent_OSpy v_evsf)) tc_Message_Omsg)} 	: UnifyingResolution(8, 9)[]
11: {(c_in v_X (c_Message_Osynth (c_Message_Oanalz (c_Event_Oknows c_Message_Oagent_OSpy v_evsf))) tc_Message_Omsg) ⊢ (c_in (c_Message_Omsg_OKey (c_Public_OshrK v_A)) (c_Message_Oparts (c_Event_Oknows c_Message_Oagent_OSpy v_evsf)) tc_Message_Omsg), (c_in v_A c_Event_Obad tc_Message_Oagent)} 	: Contraction(10)[]
12: {(c_in (c_Message_Omsg_OKey (c_Public_OshrK v_A)) (c_Message_Oparts (c_Event_Oknows c_Message_Oagent_OSpy v_evsf)) tc_Message_Omsg) ⊢ (c_in v_A c_Event_Obad tc_Message_Oagent)} 	: Axiom()[]
13: {(c_in v_X (c_Message_Osynth (c_Message_Oanalz (c_Event_Oknows c_Message_Oagent_OSpy v_evsf))) tc_Message_Omsg) ⊢ (c_in v_A c_Event_Obad tc_Message_Oagent), (c_in v_A c_Event_Obad tc_Message_Oagent)} 	: UnifyingResolution(11, 12)[]
14: {(c_in v_X (c_Message_Osynth (c_Message_Oanalz (c_Event_Oknows c_Message_Oagent_OSpy v_evsf))) tc_Message_Omsg) ⊢ (c_in v_A c_Event_Obad tc_Message_Oagent)} 	: Contraction(13)[]
15: { ⊢ (c_in v_A c_Event_Obad tc_Message_Oagent)} 	: UnifyingResolution(1, 14)[]
16: {(c_in U c_Event_Obad tc_Message_Oagent) ⊢ (c_in (c_Message_Omsg_OKey (c_Public_OshrK U)) (c_Event_Oknows c_Message_Oagent_OSpy V) tc_Message_Omsg)} 	: Axiom()[]
17: {(c_in U V W) ⊢ (c_in U (c_insert X V W) W)} 	: Axiom()[]
18: {(c_in U V tc_Message_Omsg) ⊢ (c_in U (c_Message_Oparts V) tc_Message_Omsg)} 	: Axiom()[]
19: {(c_in (c_Message_Omsg_OKey (c_Public_OshrK v_A)) (c_Message_Oparts (c_insert v_X (c_Event_Oknows c_Message_Oagent_OSpy v_evsf) tc_Message_Omsg)) tc_Message_Omsg), (c_in v_A c_Event_Obad tc_Message_Oagent) ⊢ } 	: Axiom()[]
20: {(c_in (c_Message_Omsg_OKey (c_Public_OshrK v_A)) (c_insert v_X (c_Event_Oknows c_Message_Oagent_OSpy v_evsf) tc_Message_Omsg) tc_Message_Omsg), (c_in v_A c_Event_Obad tc_Message_Oagent) ⊢ } 	: UnifyingResolution(18, 19)[]
21: {(c_in (c_Message_Omsg_OKey (c_Public_OshrK v_A)) (c_Event_Oknows c_Message_Oagent_OSpy v_evsf) tc_Message_Omsg), (c_in v_A c_Event_Obad tc_Message_Oagent) ⊢ } 	: UnifyingResolution(17, 20)[]
22: {(c_in v_A c_Event_Obad tc_Message_Oagent), (c_in v_A c_Event_Obad tc_Message_Oagent) ⊢ } 	: UnifyingResolution(16, 21)[]
23: {(c_in v_A c_Event_Obad tc_Message_Oagent) ⊢ } 	: Contraction(22)[]
24: { ⊢ } 	: UnifyingResolution(15, 23)[]

