1: { ⊢ (c_in v_evs c_OtwayRees_Ootway (tc_List_Olist tc_Event_Oevent))} 	: Axiom()[]
2: { ⊢ (c_in (c_Event_Oevent_OGets v_B (c_Message_Omsg_OMPair v_NA (c_Message_Omsg_OMPair v_X (c_Message_Omsg_OCrypt (c_Public_OshrK v_B) (c_Message_Omsg_OMPair v_NB (c_Message_Omsg_OKey v_K)))))) (c_List_Oset v_evs tc_Event_Oevent) tc_Event_Oevent)} 	: Axiom()[]
3: {(c_in (c_Event_Oevent_OGets V W) (c_List_Oset U tc_Event_Oevent) tc_Event_Oevent), (c_in U c_OtwayRees_Ootway (tc_List_Olist tc_Event_Oevent)) ⊢ (c_in (c_Event_Oevent_OSays (v_sko__usf V W U) V W) (c_List_Oset U tc_Event_Oevent) tc_Event_Oevent)} 	: Axiom()[]
4: {(c_in (c_Event_Oevent_OGets V W) (c_List_Oset v_evs tc_Event_Oevent) tc_Event_Oevent), (c_in v_evs c_OtwayRees_Ootway (tc_List_Olist tc_Event_Oevent)) ⊢ (c_in (c_Event_Oevent_OSays (v_sko__usf V W v_evs) V W) (c_List_Oset v_evs tc_Event_Oevent) tc_Event_Oevent)} 	: FOSubstitution(3)[]
5: {(c_in (c_Event_Oevent_OSays U V W) (c_List_Oset X tc_Event_Oevent) tc_Event_Oevent) ⊢ (c_in W (c_Message_Oanalz (c_Event_Oknows c_Message_Oagent_OSpy X)) tc_Message_Omsg)} 	: Axiom()[]
6: {(c_in v_evs c_OtwayRees_Ootway (tc_List_Olist tc_Event_Oevent)), (c_in (c_Event_Oevent_OGets V W) (c_List_Oset v_evs tc_Event_Oevent) tc_Event_Oevent) ⊢ (c_in W (c_Message_Oanalz (c_Event_Oknows c_Message_Oagent_OSpy v_evs)) tc_Message_Omsg)} 	: UnifyingResolutionMRR(4, 5)[]
7: {(c_in v_evs c_OtwayRees_Ootway (tc_List_Olist tc_Event_Oevent)) ⊢ (c_in (c_Message_Omsg_OMPair v_NA (c_Message_Omsg_OMPair v_X (c_Message_Omsg_OCrypt (c_Public_OshrK v_B) (c_Message_Omsg_OMPair v_NB (c_Message_Omsg_OKey v_K))))) (c_Message_Oanalz (c_Event_Oknows c_Message_Oagent_OSpy v_evs)) tc_Message_Omsg)} 	: UnifyingResolutionMRR(2, 6)[]
8: {(c_in (c_Message_Omsg_OMPair U V) (c_Message_Oanalz W) tc_Message_Omsg) ⊢ (c_in V (c_Message_Oanalz W) tc_Message_Omsg)} 	: Axiom()[]
9: {(c_in v_evs c_OtwayRees_Ootway (tc_List_Olist tc_Event_Oevent)) ⊢ (c_in (c_Message_Omsg_OMPair v_X (c_Message_Omsg_OCrypt (c_Public_OshrK v_B) (c_Message_Omsg_OMPair v_NB (c_Message_Omsg_OKey v_K)))) (c_Message_Oanalz (c_Event_Oknows c_Message_Oagent_OSpy v_evs)) tc_Message_Omsg)} 	: UnifyingResolutionMRR(7, 8)[]
10: {(c_in v_evs c_OtwayRees_Ootway (tc_List_Olist tc_Event_Oevent)) ⊢ (c_in (c_Message_Omsg_OCrypt (c_Public_OshrK v_B) (c_Message_Omsg_OMPair v_NB (c_Message_Omsg_OKey v_K))) (c_Message_Oanalz (c_Event_Oknows c_Message_Oagent_OSpy v_evs)) tc_Message_Omsg)} 	: UnifyingResolutionMRR(9, 8)[]
11: {(c_in U (c_Message_Oanalz V) tc_Message_Omsg) ⊢ (c_in U (c_Message_Oparts V) tc_Message_Omsg)} 	: Axiom()[]
12: {(c_in v_evs c_OtwayRees_Ootway (tc_List_Olist tc_Event_Oevent)) ⊢ (c_in (c_Message_Omsg_OCrypt (c_Public_OshrK v_B) (c_Message_Omsg_OMPair v_NB (c_Message_Omsg_OKey v_K))) (c_Message_Oparts (c_Event_Oknows c_Message_Oagent_OSpy v_evs)) tc_Message_Omsg)} 	: UnifyingResolutionMRR(10, 11)[]
13: { ⊢ (c_in (c_Event_Oevent_OSays v_B c_Message_Oagent_OServer (c_Message_Omsg_OMPair v_NA (c_Message_Omsg_OMPair (c_Message_Omsg_OAgent v_A) (c_Message_Omsg_OMPair (c_Message_Omsg_OAgent v_B) (c_Message_Omsg_OMPair v_X_H (c_Message_Omsg_OCrypt (c_Public_OshrK v_B) (c_Message_Omsg_OMPair v_NA (c_Message_Omsg_OMPair v_NB (c_Message_Omsg_OMPair (c_Message_Omsg_OAgent v_A) (c_Message_Omsg_OAgent v_B)))))))))) (c_List_Oset v_evs tc_Event_Oevent) tc_Event_Oevent)} 	: Axiom()[]
14: {(c_in (c_Event_Oevent_OSays V c_Message_Oagent_OServer (c_Message_Omsg_OMPair Y (c_Message_Omsg_OMPair (c_Message_Omsg_OAgent Z) (c_Message_Omsg_OMPair (c_Message_Omsg_OAgent V) (c_Message_Omsg_OMPair X1 (c_Message_Omsg_OCrypt (c_Public_OshrK V) (c_Message_Omsg_OMPair Y (c_Message_Omsg_OMPair W (c_Message_Omsg_OMPair (c_Message_Omsg_OAgent Z) (c_Message_Omsg_OAgent V)))))))))) (c_List_Oset U tc_Event_Oevent) tc_Event_Oevent), (c_in (c_Message_Omsg_OCrypt (c_Public_OshrK V) (c_Message_Omsg_OMPair W (c_Message_Omsg_OKey X))) (c_Message_Oparts (c_Event_Oknows c_Message_Oagent_OSpy U)) tc_Message_Omsg), (c_in U c_OtwayRees_Ootway (tc_List_Olist tc_Event_Oevent)) ⊢ (c_in (c_Event_Oevent_OSays c_Message_Oagent_OServer V (c_Message_Omsg_OMPair Y (c_Message_Omsg_OMPair (c_Message_Omsg_OCrypt (c_Public_OshrK Z) (c_Message_Omsg_OMPair Y (c_Message_Omsg_OKey X))) (c_Message_Omsg_OCrypt (c_Public_OshrK V) (c_Message_Omsg_OMPair W (c_Message_Omsg_OKey X)))))) (c_List_Oset U tc_Event_Oevent) tc_Event_Oevent), (c_in V c_Event_Obad tc_Message_Oagent)} 	: Axiom()[]
15: {(c_in (c_Message_Omsg_OCrypt (c_Public_OshrK v_B) (c_Message_Omsg_OMPair v_NB (c_Message_Omsg_OKey X))) (c_Message_Oparts (c_Event_Oknows c_Message_Oagent_OSpy v_evs)) tc_Message_Omsg), (c_in v_evs c_OtwayRees_Ootway (tc_List_Olist tc_Event_Oevent)) ⊢ (c_in (c_Event_Oevent_OSays c_Message_Oagent_OServer v_B (c_Message_Omsg_OMPair v_NA (c_Message_Omsg_OMPair (c_Message_Omsg_OCrypt (c_Public_OshrK v_A) (c_Message_Omsg_OMPair v_NA (c_Message_Omsg_OKey X))) (c_Message_Omsg_OCrypt (c_Public_OshrK v_B) (c_Message_Omsg_OMPair v_NB (c_Message_Omsg_OKey X)))))) (c_List_Oset v_evs tc_Event_Oevent) tc_Event_Oevent), (c_in v_B c_Event_Obad tc_Message_Oagent)} 	: UnifyingResolutionMRR(13, 14)[]
16: {(c_in (c_Event_Oevent_OSays c_Message_Oagent_OServer v_B (c_Message_Omsg_OMPair v_NA (c_Message_Omsg_OMPair (c_Message_Omsg_OCrypt (c_Public_OshrK v_A) (c_Message_Omsg_OMPair v_NA (c_Message_Omsg_OKey v_K))) (c_Message_Omsg_OCrypt (c_Public_OshrK v_B) (c_Message_Omsg_OMPair v_NB (c_Message_Omsg_OKey v_K)))))) (c_List_Oset v_evs tc_Event_Oevent) tc_Event_Oevent) ⊢ } 	: Axiom()[]
17: {(c_in (c_Message_Omsg_OCrypt (c_Public_OshrK v_B) (c_Message_Omsg_OMPair v_NB (c_Message_Omsg_OKey v_K))) (c_Message_Oparts (c_Event_Oknows c_Message_Oagent_OSpy v_evs)) tc_Message_Omsg), (c_in v_evs c_OtwayRees_Ootway (tc_List_Olist tc_Event_Oevent)) ⊢ (c_in v_B c_Event_Obad tc_Message_Oagent)} 	: UnifyingResolutionMRR(15, 16)[]
18: {(c_in v_evs c_OtwayRees_Ootway (tc_List_Olist tc_Event_Oevent)), (c_in v_evs c_OtwayRees_Ootway (tc_List_Olist tc_Event_Oevent)) ⊢ (c_in v_B c_Event_Obad tc_Message_Oagent)} 	: UnifyingResolutionMRR(12, 17)[]
19: {(c_in v_B c_Event_Obad tc_Message_Oagent) ⊢ } 	: Axiom()[]
20: {(c_in v_evs c_OtwayRees_Ootway (tc_List_Olist tc_Event_Oevent)), (c_in v_evs c_OtwayRees_Ootway (tc_List_Olist tc_Event_Oevent)) ⊢ } 	: UnifyingResolutionMRR(18, 19)[]
21: {(c_in v_evs c_OtwayRees_Ootway (tc_List_Olist tc_Event_Oevent)) ⊢ } 	: Contraction(20)[]
22: { ⊢ } 	: UnifyingResolution(1, 21)[]

