1: { ⊢ (iext uri_owl_hasSelf skc1 (literal_typed dat_str_true uri_xsd_boolean))} 	: Axiom()[]
2: { ⊢ (iext uri_owl_complementOf uri_ex_c skc1)} 	: Axiom()[]
3: {(iext uri_owl_complementOf U V) ⊢ (icext V W), (icext U W)} 	: Axiom()[]
4: { ⊢ (icext skc1 W), (icext uri_ex_c W)} 	: UnifyingResolutionMRR(2, 3)[]
5: { ⊢ (iext uri_owl_onProperty skc1 uri_rdf_type)} 	: Axiom()[]
6: {(icext U V) ⊢ (iext uri_rdf_type V U)} 	: Axiom()[]
7: {(iext uri_owl_hasSelf W X), (iext uri_owl_onProperty W U), (iext U V V) ⊢ (icext W V)} 	: Axiom()[]
8: {(icext V V), (iext uri_owl_hasSelf W X), (iext uri_owl_onProperty W uri_rdf_type) ⊢ (icext W V)} 	: UnifyingResolutionMRR(6, 7)[]
9: {(icext V V), (iext uri_owl_hasSelf skc1 X) ⊢ (icext skc1 V)} 	: UnifyingResolutionMRR(5, 8)[]
10: {(icext V V), (iext uri_owl_hasSelf skc1 (literal_typed dat_str_true uri_xsd_boolean)) ⊢ (icext skc1 V)} 	: FOSubstitution(9)[]
11: {(iext uri_owl_hasSelf skc1 (literal_typed dat_str_true uri_xsd_boolean)) ⊢ (icext skc1 uri_ex_c), (icext skc1 uri_ex_c)} 	: UnifyingResolutionMRR(4, 10)[]
12: {(iext uri_owl_hasSelf skc1 (literal_typed dat_str_true uri_xsd_boolean)) ⊢ (icext skc1 uri_ex_c)} 	: Contraction(11)[]
13: {(iext uri_owl_hasSelf U X), (iext uri_owl_onProperty U W), (icext U V) ⊢ (iext W V V)} 	: Axiom()[]
14: {(iext uri_owl_hasSelf skc1 X), (icext skc1 V) ⊢ (iext uri_rdf_type V V)} 	: UnifyingResolutionMRR(5, 13)[]
15: {(iext uri_owl_hasSelf skc1 (literal_typed dat_str_true uri_xsd_boolean)), (icext skc1 V) ⊢ (iext uri_rdf_type V V)} 	: FOSubstitution(14)[]
16: {(iext uri_rdf_type U V) ⊢ (icext V U)} 	: Axiom()[]
17: {(icext skc1 V), (iext uri_owl_hasSelf skc1 (literal_typed dat_str_true uri_xsd_boolean)) ⊢ (icext V V)} 	: UnifyingResolutionMRR(15, 16)[]
18: {(icext skc1 uri_ex_c), (iext uri_owl_hasSelf skc1 (literal_typed dat_str_true uri_xsd_boolean)) ⊢ (icext uri_ex_c uri_ex_c)} 	: FOSubstitution(17)[]
19: {(iext uri_owl_complementOf W U), (icext W V), (icext U V) ⊢ } 	: Axiom()[]
20: {(icext uri_ex_c V), (icext skc1 V) ⊢ } 	: UnifyingResolutionMRR(2, 19)[]
21: {(icext skc1 uri_ex_c), (iext uri_owl_hasSelf skc1 (literal_typed dat_str_true uri_xsd_boolean)), (icext skc1 uri_ex_c) ⊢ } 	: UnifyingResolutionMRR(18, 20)[]
22: {(icext skc1 uri_ex_c), (iext uri_owl_hasSelf skc1 (literal_typed dat_str_true uri_xsd_boolean)) ⊢ } 	: Contraction(21)[]
23: {(iext uri_owl_hasSelf skc1 (literal_typed dat_str_true uri_xsd_boolean)), (iext uri_owl_hasSelf skc1 (literal_typed dat_str_true uri_xsd_boolean)) ⊢ } 	: UnifyingResolution(12, 22)[]
24: {(iext uri_owl_hasSelf skc1 (literal_typed dat_str_true uri_xsd_boolean)) ⊢ } 	: Contraction(23)[]
25: { ⊢ } 	: UnifyingResolution(1, 24)[]

