1: { ⊢ (c_in (c_Message_Omsg_OCrypt v_K v_X) (c_union (c_Message_Oanalz (c_union v_G v_H tc_Message_Omsg)) (c_Message_Osynth v_G) tc_Message_Omsg) tc_Message_Omsg)} 	: Axiom()[]
2: {(c_in U (c_union V W X) X) ⊢ (c_in U W X), (c_in U V X)} 	: Axiom()[]
3: { ⊢ (c_in (c_Message_Omsg_OCrypt v_K v_X) (c_Message_Osynth v_G) tc_Message_Omsg), (c_in (c_Message_Omsg_OCrypt v_K v_X) (c_Message_Oanalz (c_union v_G v_H tc_Message_Omsg)) tc_Message_Omsg)} 	: UnifyingResolution(1, 2)[]
4: { ⊢ (c_in (c_Message_Omsg_OKey (c_Message_OinvKey v_K)) (c_union (c_Message_Oanalz (c_union v_G v_H tc_Message_Omsg)) (c_Message_Osynth v_G) tc_Message_Omsg) tc_Message_Omsg)} 	: Axiom()[]
5: { ⊢ (c_in (c_Message_Omsg_OKey (c_Message_OinvKey v_K)) (c_Message_Osynth v_G) tc_Message_Omsg), (c_in (c_Message_Omsg_OKey (c_Message_OinvKey v_K)) (c_Message_Oanalz (c_union v_G v_H tc_Message_Omsg)) tc_Message_Omsg)} 	: UnifyingResolution(4, 2)[]
6: {(c_in (c_Message_Omsg_OCrypt U W) (c_Message_Oanalz V) tc_Message_Omsg), (c_in (c_Message_Omsg_OKey (c_Message_OinvKey U)) (c_Message_Oanalz V) tc_Message_Omsg) ⊢ (c_in W (c_Message_Oanalz V) tc_Message_Omsg)} 	: Axiom()[]
7: {(c_in (c_Message_Omsg_OCrypt v_K W) (c_Message_Oanalz (c_union v_G v_H tc_Message_Omsg)) tc_Message_Omsg) ⊢ (c_in (c_Message_Omsg_OKey (c_Message_OinvKey v_K)) (c_Message_Osynth v_G) tc_Message_Omsg), (c_in W (c_Message_Oanalz (c_union v_G v_H tc_Message_Omsg)) tc_Message_Omsg)} 	: UnifyingResolution(5, 6)[]
8: { ⊢ (c_in (c_Message_Omsg_OCrypt v_K v_X) (c_Message_Osynth v_G) tc_Message_Omsg), (c_in (c_Message_Omsg_OKey (c_Message_OinvKey v_K)) (c_Message_Osynth v_G) tc_Message_Omsg), (c_in v_X (c_Message_Oanalz (c_union v_G v_H tc_Message_Omsg)) tc_Message_Omsg)} 	: UnifyingResolution(3, 7)[]
9: {(c_in U V W) ⊢ (c_in U (c_union V X W) W)} 	: Axiom()[]
10: {(c_in v_X (c_union (c_Message_Oanalz (c_union v_G v_H tc_Message_Omsg)) (c_Message_Osynth v_G) tc_Message_Omsg) tc_Message_Omsg) ⊢ } 	: Axiom()[]
11: {(c_in v_X (c_Message_Oanalz (c_union v_G v_H tc_Message_Omsg)) tc_Message_Omsg) ⊢ } 	: UnifyingResolution(9, 10)[]
12: { ⊢ (c_in (c_Message_Omsg_OCrypt v_K v_X) (c_Message_Osynth v_G) tc_Message_Omsg), (c_in (c_Message_Omsg_OKey (c_Message_OinvKey v_K)) (c_Message_Osynth v_G) tc_Message_Omsg)} 	: UnifyingResolution(8, 11)[]
13: {(c_in (c_Message_Omsg_OKey U) (c_Message_Osynth V) tc_Message_Omsg) ⊢ (c_in (c_Message_Omsg_OKey U) V tc_Message_Omsg)} 	: Axiom()[]
14: { ⊢ (c_in (c_Message_Omsg_OCrypt v_K v_X) (c_Message_Osynth v_G) tc_Message_Omsg), (c_in (c_Message_Omsg_OKey (c_Message_OinvKey v_K)) v_G tc_Message_Omsg)} 	: UnifyingResolution(12, 13)[]
15: {(c_in (c_Message_Omsg_OCrypt U V) (c_Message_Osynth W) tc_Message_Omsg) ⊢ (c_in (c_Message_Omsg_OCrypt U V) W tc_Message_Omsg), (c_in V (c_Message_Osynth W) tc_Message_Omsg)} 	: Axiom()[]
16: { ⊢ (c_in (c_Message_Omsg_OKey (c_Message_OinvKey v_K)) v_G tc_Message_Omsg), (c_in (c_Message_Omsg_OCrypt v_K v_X) v_G tc_Message_Omsg), (c_in v_X (c_Message_Osynth v_G) tc_Message_Omsg)} 	: UnifyingResolution(14, 15)[]
17: {(c_in U V tc_Message_Omsg) ⊢ (c_in U (c_Message_Oanalz V) tc_Message_Omsg)} 	: Axiom()[]
18: {(c_in (c_Message_Omsg_OKey (c_Message_OinvKey U)) V tc_Message_Omsg), (c_in (c_Message_Omsg_OCrypt U W) (c_Message_Oanalz V) tc_Message_Omsg) ⊢ (c_in W (c_Message_Oanalz V) tc_Message_Omsg)} 	: UnifyingResolution(17, 6)[]
19: {(c_in (c_Message_Omsg_OKey (c_Message_OinvKey v_K)) (c_union v_G v_H tc_Message_Omsg) tc_Message_Omsg) ⊢ (c_in (c_Message_Omsg_OCrypt v_K v_X) (c_Message_Osynth v_G) tc_Message_Omsg), (c_in v_X (c_Message_Oanalz (c_union v_G v_H tc_Message_Omsg)) tc_Message_Omsg)} 	: UnifyingResolution(3, 18)[]
20: {(c_in (c_Message_Omsg_OKey (c_Message_OinvKey v_K)) v_G tc_Message_Omsg) ⊢ (c_in (c_Message_Omsg_OCrypt v_K v_X) (c_Message_Osynth v_G) tc_Message_Omsg), (c_in v_X (c_Message_Oanalz (c_union v_G v_H tc_Message_Omsg)) tc_Message_Omsg)} 	: UnifyingResolution(9, 19)[]
21: {(c_in (c_Message_Omsg_OKey (c_Message_OinvKey v_K)) v_G tc_Message_Omsg) ⊢ (c_in (c_Message_Omsg_OCrypt v_K v_X) (c_Message_Osynth v_G) tc_Message_Omsg)} 	: UnifyingResolution(20, 11)[]
22: {(c_in (c_Message_Omsg_OKey (c_Message_OinvKey v_K)) v_G tc_Message_Omsg) ⊢ (c_in (c_Message_Omsg_OCrypt v_K v_X) v_G tc_Message_Omsg), (c_in v_X (c_Message_Osynth v_G) tc_Message_Omsg)} 	: UnifyingResolution(21, 15)[]
23: { ⊢ (c_in (c_Message_Omsg_OCrypt v_K v_X) v_G tc_Message_Omsg), (c_in v_X (c_Message_Osynth v_G) tc_Message_Omsg), (c_in (c_Message_Omsg_OCrypt v_K v_X) v_G tc_Message_Omsg), (c_in v_X (c_Message_Osynth v_G) tc_Message_Omsg)} 	: UnifyingResolution(16, 22)[]
24: { ⊢ (c_in (c_Message_Omsg_OCrypt v_K v_X) v_G tc_Message_Omsg), (c_in v_X (c_Message_Osynth v_G) tc_Message_Omsg)} 	: Contraction(23)[]
25: {(c_in (c_Message_Omsg_OCrypt v_K W) (c_union v_G v_H tc_Message_Omsg) tc_Message_Omsg) ⊢ (c_in (c_Message_Omsg_OKey (c_Message_OinvKey v_K)) (c_Message_Osynth v_G) tc_Message_Omsg), (c_in W (c_Message_Oanalz (c_union v_G v_H tc_Message_Omsg)) tc_Message_Omsg)} 	: UnifyingResolution(17, 7)[]
26: {(c_in (c_Message_Omsg_OCrypt v_K W) v_G tc_Message_Omsg) ⊢ (c_in (c_Message_Omsg_OKey (c_Message_OinvKey v_K)) (c_Message_Osynth v_G) tc_Message_Omsg), (c_in W (c_Message_Oanalz (c_union v_G v_H tc_Message_Omsg)) tc_Message_Omsg)} 	: UnifyingResolution(9, 25)[]
27: {(c_in (c_Message_Omsg_OCrypt v_K v_X) v_G tc_Message_Omsg) ⊢ (c_in (c_Message_Omsg_OKey (c_Message_OinvKey v_K)) (c_Message_Osynth v_G) tc_Message_Omsg)} 	: UnifyingResolution(26, 11)[]
28: {(c_in (c_Message_Omsg_OCrypt v_K v_X) v_G tc_Message_Omsg) ⊢ (c_in (c_Message_Omsg_OKey (c_Message_OinvKey v_K)) v_G tc_Message_Omsg)} 	: UnifyingResolution(27, 13)[]
29: {(c_in (c_Message_Omsg_OCrypt U W) V tc_Message_Omsg), (c_in (c_Message_Omsg_OKey (c_Message_OinvKey U)) V tc_Message_Omsg) ⊢ (c_in W (c_Message_Oanalz V) tc_Message_Omsg)} 	: UnifyingResolution(17, 18)[]
30: {(c_in (c_Message_Omsg_OCrypt U W) Z tc_Message_Omsg), (c_in (c_Message_Omsg_OKey (c_Message_OinvKey U)) (c_union Z X tc_Message_Omsg) tc_Message_Omsg) ⊢ (c_in W (c_Message_Oanalz (c_union Z X tc_Message_Omsg)) tc_Message_Omsg)} 	: UnifyingResolution(9, 29)[]
31: {(c_in (c_Message_Omsg_OKey (c_Message_OinvKey U)) Z tc_Message_Omsg), (c_in (c_Message_Omsg_OCrypt U W) Z tc_Message_Omsg) ⊢ (c_in W (c_Message_Oanalz (c_union Z X tc_Message_Omsg)) tc_Message_Omsg)} 	: UnifyingResolution(9, 30)[]
32: {(c_in (c_Message_Omsg_OCrypt v_K v_X) v_G tc_Message_Omsg), (c_in (c_Message_Omsg_OCrypt v_K W) v_G tc_Message_Omsg) ⊢ (c_in W (c_Message_Oanalz (c_union v_G X tc_Message_Omsg)) tc_Message_Omsg)} 	: UnifyingResolution(28, 31)[]
33: {(c_in (c_Message_Omsg_OCrypt v_K v_X) v_G tc_Message_Omsg), (c_in (c_Message_Omsg_OCrypt v_K v_X) v_G tc_Message_Omsg) ⊢ } 	: UnifyingResolution(32, 11)[]
34: {(c_in (c_Message_Omsg_OCrypt v_K v_X) v_G tc_Message_Omsg) ⊢ } 	: Contraction(33)[]
35: { ⊢ (c_in v_X (c_Message_Osynth v_G) tc_Message_Omsg)} 	: UnifyingResolution(24, 34)[]
36: {(c_in U V W) ⊢ (c_in U (c_union X V W) W)} 	: Axiom()[]
37: {(c_in v_X (c_Message_Osynth v_G) tc_Message_Omsg) ⊢ } 	: UnifyingResolution(36, 10)[]
38: { ⊢ } 	: UnifyingResolution(35, 37)[]

