1: { ⊢ (environment skc3)} 	: Axiom()[]
2: { ⊢ (outcompetes first_movers efficient_producers skc2)} 	: Axiom()[]
3: { ⊢ (subpopulations first_movers efficient_producers skc3 skc2)} 	: Axiom()[]
4: {(subpopulations first_movers efficient_producers U V), (environment U) ⊢ (in_environment U V)} 	: Axiom()[]
5: {(subpopulations first_movers efficient_producers skc3 V), (environment skc3) ⊢ (in_environment skc3 V)} 	: FOSubstitution(4)[]
6: {(environment skc3) ⊢ (in_environment skc3 skc2)} 	: UnifyingResolutionMRR(3, 5)[]
7: {(subpopulations V W U X), (environment U) ⊢ (greater_or_equal (growth_rate V X) zero), (greater zero (growth_rate V X))} 	: Axiom()[]
8: {(subpopulations V W skc3 X), (environment skc3) ⊢ (greater_or_equal (growth_rate V X) zero), (greater zero (growth_rate V X))} 	: FOSubstitution(7)[]
9: {(environment skc3) ⊢ (greater_or_equal (growth_rate first_movers skc2) zero), (greater zero (growth_rate first_movers skc2))} 	: UnifyingResolutionMRR(3, 8)[]
10: {(greater zero (growth_rate U V)) ⊢ (subpopulations U W X V)} 	: Axiom()[]
11: {(environment skc3) ⊢ (greater_or_equal (growth_rate first_movers skc2) zero), (subpopulations first_movers W X skc2)} 	: UnifyingResolutionMRR(9, 10)[]
12: {(subpopulations V W U X), (environment U) ⊢ (subpopulations W V U X)} 	: Axiom()[]
13: {(subpopulations V W skc3 X), (environment skc3) ⊢ (subpopulations W V skc3 X)} 	: FOSubstitution(12)[]
14: {(environment skc3), (environment skc3) ⊢ (greater_or_equal (growth_rate first_movers skc2) zero), (subpopulations W first_movers skc3 skc2)} 	: UnifyingResolutionMRR(11, 13)[]
15: {(subpopulations W V U X), (outcompetes V W X), (environment U) ⊢ (greater_or_equal (growth_rate V X) zero)} 	: Axiom()[]
16: {(subpopulations W V skc3 X), (outcompetes V W X), (environment skc3) ⊢ (greater_or_equal (growth_rate V X) zero)} 	: FOSubstitution(15)[]
17: {(environment skc3), (environment skc3), (outcompetes first_movers W skc2), (environment skc3) ⊢ (greater_or_equal (growth_rate first_movers skc2) zero), (greater_or_equal (growth_rate first_movers skc2) zero)} 	: UnifyingResolutionMRR(14, 16)[]
18: {(environment skc3), (outcompetes first_movers W skc2) ⊢ (greater_or_equal (growth_rate first_movers skc2) zero)} 	: Contraction(17)[]
19: { ⊢ (greater (resilience efficient_producers) (resilience first_movers))} 	: Axiom()[]
20: {(subpopulations V W skc3 X), (environment skc3) ⊢ (subpopulations W V skc3 X)} 	: FOSubstitution(12)[]
21: {(environment skc3) ⊢ (subpopulations efficient_producers first_movers skc3 skc2)} 	: UnifyingResolutionMRR(3, 20)[]
22: {(subpopulations V W skc3 X), (environment skc3) ⊢ (greater_or_equal (growth_rate V X) zero), (greater zero (growth_rate V X))} 	: FOSubstitution(7)[]
23: {(environment skc3), (environment skc3) ⊢ (greater_or_equal (growth_rate efficient_producers skc2) zero), (greater zero (growth_rate efficient_producers skc2))} 	: UnifyingResolutionMRR(21, 22)[]
24: {(greater (resilience W) (resilience X)), (greater zero (growth_rate W V)), (in_environment U V), (environment U) ⊢ (greater zero (growth_rate X V))} 	: Axiom()[]
25: {(greater (resilience W) (resilience X)), (greater zero (growth_rate W V)), (in_environment skc3 V), (environment skc3) ⊢ (greater zero (growth_rate X V))} 	: FOSubstitution(24)[]
26: {(environment skc3), (environment skc3), (greater (resilience efficient_producers) (resilience X)), (in_environment skc3 skc2), (environment skc3) ⊢ (greater_or_equal (growth_rate efficient_producers skc2) zero), (greater zero (growth_rate X skc2))} 	: UnifyingResolutionMRR(23, 25)[]
27: {(environment skc3), (environment skc3), (in_environment skc3 skc2), (environment skc3) ⊢ (greater_or_equal (growth_rate efficient_producers skc2) zero), (greater zero (growth_rate first_movers skc2))} 	: UnifyingResolutionMRR(19, 26)[]
28: {(environment skc3), (in_environment skc3 skc2) ⊢ (greater_or_equal (growth_rate efficient_producers skc2) zero), (greater zero (growth_rate first_movers skc2))} 	: Contraction(27)[]
29: {(greater_or_equal (growth_rate U V) zero), (greater zero (growth_rate U V)) ⊢ } 	: Axiom()[]
30: {(environment skc3), (in_environment skc3 skc2), (greater_or_equal (growth_rate first_movers skc2) zero) ⊢ (greater_or_equal (growth_rate efficient_producers skc2) zero)} 	: UnifyingResolutionMRR(28, 29)[]
31: {(environment skc3), (outcompetes first_movers W skc2), (environment skc3), (in_environment skc3 skc2) ⊢ (greater_or_equal (growth_rate efficient_producers skc2) zero)} 	: UnifyingResolutionMRR(18, 30)[]
32: {(outcompetes first_movers efficient_producers skc2), (environment skc3), (in_environment skc3 skc2) ⊢ (greater_or_equal (growth_rate efficient_producers skc2) zero)} 	: Contraction(31)[]
33: {(subpopulations W V U X), (outcompetes V W X), (environment U) ⊢ (greater zero (growth_rate W X))} 	: Axiom()[]
34: {(subpopulations W V skc3 X), (outcompetes V W X), (environment skc3) ⊢ (greater zero (growth_rate W X))} 	: FOSubstitution(33)[]
35: {(environment skc3), (outcompetes first_movers efficient_producers skc2), (environment skc3) ⊢ (greater zero (growth_rate efficient_producers skc2))} 	: UnifyingResolutionMRR(21, 34)[]
36: {(environment skc3), (outcompetes first_movers efficient_producers skc2), (environment skc3), (greater_or_equal (growth_rate efficient_producers skc2) zero) ⊢ } 	: UnifyingResolutionMRR(35, 29)[]
37: {(outcompetes first_movers efficient_producers skc2), (environment skc3), (in_environment skc3 skc2), (environment skc3), (outcompetes first_movers efficient_producers skc2), (environment skc3) ⊢ } 	: UnifyingResolutionMRR(32, 36)[]
38: {(environment skc3), (outcompetes first_movers efficient_producers skc2), (environment skc3), (environment skc3), (outcompetes first_movers efficient_producers skc2), (environment skc3) ⊢ } 	: UnifyingResolutionMRR(6, 37)[]
39: {(environment skc3), (outcompetes first_movers efficient_producers skc2) ⊢ } 	: Contraction(38)[]
40: {(environment skc3) ⊢ } 	: UnifyingResolution(2, 39)[]
41: { ⊢ } 	: UnifyingResolution(1, 40)[]

